
PokerStars Zoom Hand #120944903144:  Hold'em No Limit ($0.01/$0.02) - 2014/09/02 6:03:52 ET
Table 'Halley' 6-max Seat #1 is the button
Seat 1: trololo100 ($2.17 in chips) 
Seat 2: devil1337 ($2 in chips) 
Seat 3: deoxy1909 ($1.87 in chips) 
Seat 4: OOOleg31 ($2.33 in chips) 
Seat 5: 96Nico ($2.20 in chips) 
Seat 6: lookintomye ($5.06 in chips) 
devil1337: posts small blind $0.01
deoxy1909: posts big blind $0.02
*** HOLE CARDS ***
Dealt to deoxy1909 [9s 7s]
OOOleg31: raises $0.02 to $0.04
96Nico: folds 
lookintomye: raises $0.16 to $0.20
trololo100: folds 
devil1337: folds 
deoxy1909: folds 
OOOleg31: calls $0.16
*** FLOP *** [4h Qd Qs]
OOOleg31: bets $0.40
lookintomye: calls $0.40
*** TURN *** [4h Qd Qs] [9c]
OOOleg31: bets $0.02
lookintomye: calls $0.02
*** RIVER *** [4h Qd Qs 9c] [Ts]
OOOleg31: bets $1.22
lookintomye: calls $1.22
*** SHOW DOWN ***
OOOleg31: shows [Td Jh] (two pair, Queens and Tens)
lookintomye: shows [Ah Ac] (two pair, Aces and Queens)
lookintomye collected $3.58 from pot
*** SUMMARY ***
Total pot $3.71 | Rake $0.13 
Board [4h Qd Qs 9c Ts]
Seat 1: trololo100 (button) folded before Flop (didn't bet)
Seat 2: devil1337 (small blind) folded before Flop
Seat 3: deoxy1909 (big blind) folded before Flop
Seat 4: OOOleg31 showed [Td Jh] and lost with two pair, Queens and Tens
Seat 5: 96Nico folded before Flop (didn't bet)
Seat 6: lookintomye showed [Ah Ac] and won ($3.58) with two pair, Aces and Queens



PokerStars Zoom Hand #120944950182:  Hold'em No Limit ($0.01/$0.02) - 2014/09/02 6:05:39 ET
Table 'Halley' 6-max Seat #1 is the button
Seat 1: deoxy1909 ($1.83 in chips) 
Seat 2: Graul2013 ($2.08 in chips) 
Seat 3: Aleks Ryder ($4.24 in chips) 
Seat 4: ~StarL!ght~ ($0.35 in chips) 
Seat 5: dagfort ($0.59 in chips) 
Seat 6: ziga992SLO ($1.82 in chips) 
Graul2013: posts small blind $0.01
Aleks Ryder: posts big blind $0.02
*** HOLE CARDS ***
Dealt to deoxy1909 [Ks 7d]
~StarL!ght~: calls $0.02
dagfort: folds 
ziga992SLO: raises $0.04 to $0.06
deoxy1909: folds 
Graul2013: folds 
Aleks Ryder: folds 
~StarL!ght~: calls $0.04
*** FLOP *** [2c 3c Qc]
~StarL!ght~: checks 
ziga992SLO: bets $0.14
~StarL!ght~: calls $0.14
*** TURN *** [2c 3c Qc] [3h]
~StarL!ght~: checks 
ziga992SLO: bets $1.62 and is all-in
~StarL!ght~: calls $0.15 and is all-in
Uncalled bet ($1.47) returned to ziga992SLO
*** RIVER *** [2c 3c Qc 3h] [Jd]
*** SHOW DOWN ***
~StarL!ght~: shows [Js Kc] (two pair, Jacks and Threes)
ziga992SLO: mucks hand 
~StarL!ght~ collected $0.70 from pot
*** SUMMARY ***
Total pot $0.73 | Rake $0.03 
Board [2c 3c Qc 3h Jd]
Seat 1: deoxy1909 (button) folded before Flop (didn't bet)
Seat 2: Graul2013 (small blind) folded before Flop
Seat 3: Aleks Ryder (big blind) folded before Flop
Seat 4: ~StarL!ght~ showed [Js Kc] and won ($0.70) with two pair, Jacks and Threes
Seat 5: dagfort folded before Flop (didn't bet)
Seat 6: ziga992SLO mucked [As Td]



PokerStars Zoom Hand #120945021833:  Hold'em No Limit ($0.01/$0.02) - 2014/09/02 6:08:22 ET
Table 'Halley' 6-max Seat #1 is the button
Seat 1: one piiece ($2.11 in chips) 
Seat 2: deoxy1909 ($1.85 in chips) 
Seat 3: D. Brabo ($0.55 in chips) 
Seat 4: Coll@pse ($2.53 in chips) 
Seat 5: devil1337 ($2 in chips) 
Seat 6: chalanisko ($3.02 in chips) 
deoxy1909: posts small blind $0.01
D. Brabo: posts big blind $0.02
*** HOLE CARDS ***
Dealt to deoxy1909 [Qh Kh]
Coll@pse: folds 
devil1337: raises $0.04 to $0.06
chalanisko: folds 
one piiece: folds 
deoxy1909: calls $0.05
D. Brabo: folds 
*** FLOP *** [9s 7d 6s]
deoxy1909: checks 
devil1337: bets $0.08
deoxy1909: calls $0.08
*** TURN *** [9s 7d 6s] [7h]
deoxy1909: checks 
devil1337: bets $0.16
deoxy1909: calls $0.16
*** RIVER *** [9s 7d 6s 7h] [Ts]
deoxy1909: checks 
devil1337: bets $0.21
deoxy1909: calls $0.21
*** SHOW DOWN ***
devil1337: shows [8s 9d] (a straight, Six to Ten)
deoxy1909: mucks hand 
devil1337 collected $1 from pot
*** SUMMARY ***
Total pot $1.04 | Rake $0.04 
Board [9s 7d 6s 7h Ts]
Seat 1: one piiece (button) folded before Flop (didn't bet)
Seat 2: deoxy1909 (small blind) mucked [Qh Kh]
Seat 3: D. Brabo (big blind) folded before Flop
Seat 4: Coll@pse folded before Flop (didn't bet)
Seat 5: devil1337 showed [8s 9d] and won ($1) with a straight, Six to Ten
Seat 6: chalanisko folded before Flop (didn't bet)



PokerStars Zoom Hand #120945463158:  Hold'em No Limit ($0.01/$0.02) - 2014/09/02 6:24:59 ET
Table 'Halley' 6-max Seat #1 is the button
Seat 1: nly123 ($2.46 in chips) 
Seat 2: deoxy1909 ($1.29 in chips) 
Seat 3: krzywy68 ($6.43 in chips) 
Seat 4: Marek Wolf ($1.14 in chips) 
Seat 5: PlayerBet89 ($1.65 in chips) 
Seat 6: angru123 ($1.92 in chips) 
deoxy1909: posts small blind $0.01
krzywy68: posts big blind $0.02
*** HOLE CARDS ***
Dealt to deoxy1909 [Jc Kc]
Marek Wolf: calls $0.02
PlayerBet89: raises $0.04 to $0.06
angru123: calls $0.06
nly123: calls $0.06
deoxy1909: folds 
krzywy68: folds 
Marek Wolf: raises $0.24 to $0.30
PlayerBet89: folds 
angru123: calls $0.24
nly123: folds 
*** FLOP *** [9h 4s Jd]
Marek Wolf: bets $0.30
angru123: calls $0.30
*** TURN *** [9h 4s Jd] [2s]
Marek Wolf: bets $0.54 and is all-in
angru123: folds 
Uncalled bet ($0.54) returned to Marek Wolf
Marek Wolf collected $1.30 from pot
Marek Wolf: doesn't show hand 
*** SUMMARY ***
Total pot $1.35 | Rake $0.05 
Board [9h 4s Jd 2s]
Seat 1: nly123 (button) folded before Flop
Seat 2: deoxy1909 (small blind) folded before Flop
Seat 3: krzywy68 (big blind) folded before Flop
Seat 4: Marek Wolf collected ($1.30)
Seat 5: PlayerBet89 folded before Flop
Seat 6: angru123 folded on the Turn



PokerStars Zoom Hand #120945741562:  Hold'em No Limit ($0.01/$0.02) - 2014/09/02 6:35:23 ET
Table 'Halley' 6-max Seat #1 is the button
Seat 1: D. Brabo ($5.51 in chips) 
Seat 2: nonex truth ($1.68 in chips) 
Seat 3: deoxy1909 ($1.42 in chips) 
Seat 4: Itsalmost ($3.20 in chips) 
Seat 5: BABS217 ($7.67 in chips) 
Seat 6: wkulig ($2.12 in chips) 
nonex truth: posts small blind $0.01
deoxy1909: posts big blind $0.02
*** HOLE CARDS ***
Dealt to deoxy1909 [7d 6c]
Itsalmost: folds 
BABS217: folds 
wkulig: raises $0.04 to $0.06
D. Brabo: folds 
nonex truth: raises $0.10 to $0.16
deoxy1909: folds 
wkulig: calls $0.10
*** FLOP *** [Qh 6s Kc]
nonex truth: bets $0.14
wkulig: calls $0.14
*** TURN *** [Qh 6s Kc] [9s]
nonex truth: checks 
wkulig: bets $0.40
nonex truth: folds 
Uncalled bet ($0.40) returned to wkulig
wkulig collected $0.60 from pot
wkulig: doesn't show hand 
*** SUMMARY ***
Total pot $0.62 | Rake $0.02 
Board [Qh 6s Kc 9s]
Seat 1: D. Brabo (button) folded before Flop (didn't bet)
Seat 2: nonex truth (small blind) folded on the Turn
Seat 3: deoxy1909 (big blind) folded before Flop
Seat 4: Itsalmost folded before Flop (didn't bet)
Seat 5: BABS217 folded before Flop (didn't bet)
Seat 6: wkulig collected ($0.60)



PokerStars Zoom Hand #120945804393:  Hold'em No Limit ($0.01/$0.02) - 2014/09/02 6:37:42 ET
Table 'Halley' 6-max Seat #1 is the button
Seat 1: Tod_Brown ($1.25 in chips) 
Seat 2: deoxy1909 ($1.49 in chips) 
Seat 3: 22pokerM ($2.42 in chips) 
Seat 4: golayapravda ($1.90 in chips) 
Seat 5: coljmcn ($6.92 in chips) 
Seat 6: gobelno ($2.01 in chips) 
deoxy1909: posts small blind $0.01
22pokerM: posts big blind $0.02
*** HOLE CARDS ***
Dealt to deoxy1909 [3h 2s]
golayapravda: calls $0.02
coljmcn: raises $0.03 to $0.05
gobelno: folds 
Tod_Brown: calls $0.05
deoxy1909: folds 
22pokerM: folds 
golayapravda: calls $0.03
*** FLOP *** [Ts 7d 6h]
golayapravda: checks 
coljmcn: checks 
Tod_Brown: bets $0.08
golayapravda: calls $0.08
coljmcn: folds 
*** TURN *** [Ts 7d 6h] [Qh]
golayapravda: bets $0.02
Tod_Brown: raises $0.16 to $0.18
golayapravda: calls $0.16
*** RIVER *** [Ts 7d 6h Qh] [Jh]
golayapravda: checks 
Tod_Brown: bets $0.34
golayapravda: calls $0.34
*** SHOW DOWN ***
Tod_Brown: shows [Jd Qs] (two pair, Queens and Jacks)
golayapravda: mucks hand 
Tod_Brown collected $1.33 from pot
*** SUMMARY ***
Total pot $1.38 | Rake $0.05 
Board [Ts 7d 6h Qh Jh]
Seat 1: Tod_Brown (button) showed [Jd Qs] and won ($1.33) with two pair, Queens and Jacks
Seat 2: deoxy1909 (small blind) folded before Flop
Seat 3: 22pokerM (big blind) folded before Flop
Seat 4: golayapravda mucked [As Jc]
Seat 5: coljmcn folded on the Flop
Seat 6: gobelno folded before Flop (didn't bet)



PokerStars Zoom Hand #120945842423:  Hold'em No Limit ($0.01/$0.02) - 2014/09/02 6:39:07 ET
Table 'Halley' 6-max Seat #1 is the button
Seat 1: deoxy1909 ($1.45 in chips) 
Seat 2: kac1k ($4.30 in chips) 
Seat 3: leafer13ca ($2 in chips) 
Seat 4: saltydog418 ($3.93 in chips) 
Seat 5: LouisstWulf ($1.10 in chips) 
Seat 6: avd74 ($3.68 in chips) 
kac1k: posts small blind $0.01
leafer13ca: posts big blind $0.02
*** HOLE CARDS ***
Dealt to deoxy1909 [5d Td]
saltydog418: folds 
LouisstWulf: folds 
avd74: folds 
deoxy1909: folds 
kac1k: raises $0.04 to $0.06
leafer13ca: calls $0.04
*** FLOP *** [3c 6d Kh]
kac1k: bets $0.07
leafer13ca: raises $0.07 to $0.14
kac1k: calls $0.07
*** TURN *** [3c 6d Kh] [Ad]
kac1k: checks 
leafer13ca: checks 
*** RIVER *** [3c 6d Kh Ad] [Ks]
kac1k: checks 
leafer13ca: bets $0.12
kac1k: calls $0.12
*** SHOW DOWN ***
leafer13ca: shows [6s Kc] (a full house, Kings full of Sixes)
kac1k: mucks hand 
leafer13ca collected $0.62 from pot
*** SUMMARY ***
Total pot $0.64 | Rake $0.02 
Board [3c 6d Kh Ad Ks]
Seat 1: deoxy1909 (button) folded before Flop (didn't bet)
Seat 2: kac1k (small blind) mucked [Qh Qs]
Seat 3: leafer13ca (big blind) showed [6s Kc] and won ($0.62) with a full house, Kings full of Sixes
Seat 4: saltydog418 folded before Flop (didn't bet)
Seat 5: LouisstWulf folded before Flop (didn't bet)
Seat 6: avd74 folded before Flop (didn't bet)



PokerStars Zoom Hand #120945963578:  Hold'em No Limit ($0.01/$0.02) - 2014/09/02 6:43:32 ET
Table 'Halley' 6-max Seat #1 is the button
Seat 1: X1118 ($2 in chips) 
Seat 2: yaroslav.s94 ($2.55 in chips) 
Seat 3: IMPENGIM ($3.89 in chips) 
Seat 4: ewenement8 ($1.82 in chips) 
Seat 5: deoxy1909 ($1.29 in chips) 
Seat 6: Swoszman ($2.23 in chips) 
yaroslav.s94: posts small blind $0.01
IMPENGIM: posts big blind $0.02
*** HOLE CARDS ***
Dealt to deoxy1909 [Jd As]
ewenement8: folds 
deoxy1909: raises $0.04 to $0.06
Swoszman: folds 
X1118: folds 
yaroslav.s94: folds 
IMPENGIM: calls $0.04
*** FLOP *** [Tc 3h 7d]
IMPENGIM: checks 
deoxy1909: checks 
*** TURN *** [Tc 3h 7d] [Qs]
IMPENGIM: bets $0.06
deoxy1909: calls $0.06
*** RIVER *** [Tc 3h 7d Qs] [4s]
IMPENGIM: bets $0.14
deoxy1909: calls $0.14
*** SHOW DOWN ***
IMPENGIM: shows [Ts Js] (a pair of Tens)
deoxy1909: mucks hand 
IMPENGIM collected $0.51 from pot
*** SUMMARY ***
Total pot $0.53 | Rake $0.02 
Board [Tc 3h 7d Qs 4s]
Seat 1: X1118 (button) folded before Flop (didn't bet)
Seat 2: yaroslav.s94 (small blind) folded before Flop
Seat 3: IMPENGIM (big blind) showed [Ts Js] and won ($0.51) with a pair of Tens
Seat 4: ewenement8 folded before Flop (didn't bet)
Seat 5: deoxy1909 mucked [Jd As]
Seat 6: Swoszman folded before Flop (didn't bet)



PokerStars Zoom Hand #120947007673:  Hold'em No Limit ($0.01/$0.02) - 2014/09/02 7:21:15 ET
Table 'Halley' 6-max Seat #1 is the button
Seat 1: Allexii ($0.82 in chips) 
Seat 2: man070707 ($1.82 in chips) 
Seat 3: deoxy1909 ($1.37 in chips) 
Seat 4: secretive87 ($2 in chips) 
Seat 5: Jonny_Navaro ($1.61 in chips) 
Seat 6: gaellita ($2.11 in chips) 
man070707: posts small blind $0.01
deoxy1909: posts big blind $0.02
*** HOLE CARDS ***
Dealt to deoxy1909 [Th 5d]
secretive87: calls $0.02
Jonny_Navaro: folds 
gaellita: folds 
Allexii: folds 
man070707: raises $0.02 to $0.04
deoxy1909: folds 
secretive87: calls $0.02
*** FLOP *** [As Qc Qd]
man070707: bets $0.05
secretive87: calls $0.05
*** TURN *** [As Qc Qd] [Ks]
man070707: bets $0.06
secretive87: raises $0.14 to $0.20
man070707: calls $0.14
*** RIVER *** [As Qc Qd Ks] [8h]
man070707: checks 
secretive87: bets $0.28
man070707: calls $0.28
*** SHOW DOWN ***
secretive87: shows [Jh Qs] (three of a kind, Queens)
man070707: mucks hand 
secretive87 collected $1.12 from pot
*** SUMMARY ***
Total pot $1.16 | Rake $0.04 
Board [As Qc Qd Ks 8h]
Seat 1: Allexii (button) folded before Flop (didn't bet)
Seat 2: man070707 (small blind) mucked [Ad Ts]
Seat 3: deoxy1909 (big blind) folded before Flop
Seat 4: secretive87 showed [Jh Qs] and won ($1.12) with three of a kind, Queens
Seat 5: Jonny_Navaro folded before Flop (didn't bet)
Seat 6: gaellita folded before Flop (didn't bet)



PokerStars Zoom Hand #120947137124:  Hold'em No Limit ($0.01/$0.02) - 2014/09/02 7:25:38 ET
Table 'Halley' 6-max Seat #1 is the button
Seat 1: deoxy1909 ($1.31 in chips) 
Seat 2: =STOHASTIK= ($0.98 in chips) 
Seat 3: OZ 33799 ($2.02 in chips) 
Seat 4: la cachi-77 ($0.89 in chips) 
Seat 5: marrrx ($2.37 in chips) 
Seat 6: str12380 ($3.30 in chips) 
=STOHASTIK=: posts small blind $0.01
OZ 33799: posts big blind $0.02
*** HOLE CARDS ***
Dealt to deoxy1909 [Qd 8h]
la cachi-77: calls $0.02
marrrx: folds 
str12380: raises $0.02 to $0.04
deoxy1909: folds 
=STOHASTIK=: raises $0.04 to $0.08
OZ 33799: folds 
la cachi-77: calls $0.06
str12380: calls $0.04
*** FLOP *** [Th 9h 2h]
=STOHASTIK=: checks 
la cachi-77: checks 
str12380: bets $0.18
=STOHASTIK=: calls $0.18
la cachi-77: folds 
*** TURN *** [Th 9h 2h] [Js]
=STOHASTIK=: checks 
str12380: bets $0.60
=STOHASTIK=: folds 
Uncalled bet ($0.60) returned to str12380
str12380 collected $0.60 from pot
str12380: doesn't show hand 
*** SUMMARY ***
Total pot $0.62 | Rake $0.02 
Board [Th 9h 2h Js]
Seat 1: deoxy1909 (button) folded before Flop (didn't bet)
Seat 2: =STOHASTIK= (small blind) folded on the Turn
Seat 3: OZ 33799 (big blind) folded before Flop
Seat 4: la cachi-77 folded on the Flop
Seat 5: marrrx folded before Flop (didn't bet)
Seat 6: str12380 collected ($0.60)



PokerStars Zoom Hand #120947306044:  Hold'em No Limit ($0.01/$0.02) - 2014/09/02 7:31:17 ET
Table 'Halley' 6-max Seat #1 is the button
Seat 1: deoxy1909 ($1.29 in chips) 
Seat 2: Disharmonist ($2 in chips) 
Seat 3: Emily591 ($2.17 in chips) 
Seat 4: sergiy6304 ($2.01 in chips) 
Seat 5: MrMartingale ($1.32 in chips) 
Seat 6: HadYock ($2.22 in chips) 
Disharmonist: posts small blind $0.01
Emily591: posts big blind $0.02
*** HOLE CARDS ***
Dealt to deoxy1909 [As 3s]
sergiy6304: folds 
MrMartingale: folds 
HadYock: folds 
deoxy1909: folds 
Disharmonist: raises $0.04 to $0.06
Emily591: calls $0.04
*** FLOP *** [Jd 4h 7s]
Disharmonist: bets $0.09
Emily591: calls $0.09
*** TURN *** [Jd 4h 7s] [Js]
Disharmonist: bets $0.23
Emily591: raises $0.23 to $0.46
Disharmonist: folds 
Uncalled bet ($0.23) returned to Emily591
Emily591 collected $0.73 from pot
Emily591: doesn't show hand 
*** SUMMARY ***
Total pot $0.76 | Rake $0.03 
Board [Jd 4h 7s Js]
Seat 1: deoxy1909 (button) folded before Flop (didn't bet)
Seat 2: Disharmonist (small blind) folded on the Turn
Seat 3: Emily591 (big blind) collected ($0.73)
Seat 4: sergiy6304 folded before Flop (didn't bet)
Seat 5: MrMartingale folded before Flop (didn't bet)
Seat 6: HadYock folded before Flop (didn't bet)



PokerStars Zoom Hand #120947332831:  Hold'em No Limit ($0.01/$0.02) - 2014/09/02 7:32:10 ET
Table 'Halley' 6-max Seat #1 is the button
Seat 1: mrck14 ($3.65 in chips) 
Seat 2: deoxy1909 ($1.26 in chips) 
Seat 3: Disharmonist ($2.20 in chips) 
Seat 4: Walera Koz ($4.59 in chips) 
Seat 5: riverflush14 ($1.32 in chips) 
Seat 6: ferinko1809 ($0.75 in chips) 
deoxy1909: posts small blind $0.01
Disharmonist: posts big blind $0.02
*** HOLE CARDS ***
Dealt to deoxy1909 [3c 4c]
Walera Koz: raises $0.02 to $0.04
riverflush14: calls $0.04
ferinko1809: calls $0.04
mrck14: raises $0.14 to $0.18
deoxy1909: folds 
Disharmonist: folds 
Walera Koz: folds 
riverflush14: calls $0.14
ferinko1809: folds 
*** FLOP *** [2h 7c Th]
riverflush14: checks 
mrck14: bets $0.18
riverflush14: calls $0.18
*** TURN *** [2h 7c Th] [Ts]
riverflush14: checks 
mrck14: bets $0.40
riverflush14: raises $0.56 to $0.96 and is all-in
mrck14: calls $0.56
*** RIVER *** [2h 7c Th Ts] [Kc]
*** SHOW DOWN ***
riverflush14: shows [2s 2d] (a full house, Deuces full of Tens)
mrck14: shows [Ad As] (two pair, Aces and Tens)
riverflush14 collected $2.65 from pot
*** SUMMARY ***
Total pot $2.75 | Rake $0.10 
Board [2h 7c Th Ts Kc]
Seat 1: mrck14 (button) showed [Ad As] and lost with two pair, Aces and Tens
Seat 2: deoxy1909 (small blind) folded before Flop
Seat 3: Disharmonist (big blind) folded before Flop
Seat 4: Walera Koz folded before Flop
Seat 5: riverflush14 showed [2s 2d] and won ($2.65) with a full house, Deuces full of Tens
Seat 6: ferinko1809 folded before Flop



PokerStars Zoom Hand #120947403686:  Hold'em No Limit ($0.01/$0.02) - 2014/09/02 7:34:29 ET
Table 'Halley' 6-max Seat #1 is the button
Seat 1: ztema ($2.35 in chips) 
Seat 2: Papci777 ($1.33 in chips) 
Seat 3: deoxy1909 ($1.25 in chips) 
Seat 4: kounamoutas ($3 in chips) 
Seat 5: minidance ($2.04 in chips) 
Seat 6: Nuc1earL0v3 ($2.75 in chips) 
Papci777: posts small blind $0.01
deoxy1909: posts big blind $0.02
*** HOLE CARDS ***
Dealt to deoxy1909 [Qh Qs]
kounamoutas: raises $0.04 to $0.06
minidance: folds 
Nuc1earL0v3: folds 
ztema: folds 
Papci777: calls $0.05
deoxy1909: raises $0.18 to $0.24
kounamoutas: calls $0.18
Papci777: calls $0.18
*** FLOP *** [Ac 7s 5c]
Papci777: checks 
deoxy1909: bets $0.52
kounamoutas: folds 
Papci777: raises $0.52 to $1.04
deoxy1909: calls $0.49 and is all-in
Uncalled bet ($0.03) returned to Papci777
*** TURN *** [Ac 7s 5c] [4d]
*** RIVER *** [Ac 7s 5c 4d] [3c]
*** SHOW DOWN ***
Papci777: shows [Td Ah] (a pair of Aces)
deoxy1909: shows [Qh Qs] (a pair of Queens)
Papci777 collected $2.64 from pot
*** SUMMARY ***
Total pot $2.74 | Rake $0.10 
Board [Ac 7s 5c 4d 3c]
Seat 1: ztema (button) folded before Flop (didn't bet)
Seat 2: Papci777 (small blind) showed [Td Ah] and won ($2.64) with a pair of Aces
Seat 3: deoxy1909 (big blind) showed [Qh Qs] and lost with a pair of Queens
Seat 4: kounamoutas folded on the Flop
Seat 5: minidance folded before Flop (didn't bet)
Seat 6: Nuc1earL0v3 folded before Flop (didn't bet)



PokerStars Zoom Hand #120947774345:  Hold'em No Limit ($0.01/$0.02) - 2014/09/02 7:46:36 ET
Table 'Halley' 6-max Seat #1 is the button
Seat 1: ciombitz ($2.08 in chips) 
Seat 2: irepela ($2.24 in chips) 
Seat 3: Aleks Ryder ($4.20 in chips) 
Seat 4: deoxy1909 ($1.97 in chips) 
Seat 5: <v<Kar1nA>^> ($3.39 in chips) 
Seat 6: vagon21 ($2.15 in chips) 
irepela: posts small blind $0.01
Aleks Ryder: posts big blind $0.02
*** HOLE CARDS ***
Dealt to deoxy1909 [Jh Ks]
deoxy1909: raises $0.04 to $0.06
<v<Kar1nA>^>: folds 
vagon21: calls $0.06
ciombitz: folds 
irepela: folds 
Aleks Ryder: folds 
*** FLOP *** [7h Kc 9d]
deoxy1909: bets $0.10
vagon21: calls $0.10
*** TURN *** [7h Kc 9d] [4c]
deoxy1909: bets $0.24
vagon21: calls $0.24
*** RIVER *** [7h Kc 9d 4c] [2d]
deoxy1909: bets $0.60
vagon21: calls $0.60
*** SHOW DOWN ***
deoxy1909: shows [Jh Ks] (a pair of Kings)
vagon21: shows [Ah Kd] (a pair of Kings - Ace kicker)
vagon21 collected $1.96 from pot
*** SUMMARY ***
Total pot $2.03 | Rake $0.07 
Board [7h Kc 9d 4c 2d]
Seat 1: ciombitz (button) folded before Flop (didn't bet)
Seat 2: irepela (small blind) folded before Flop
Seat 3: Aleks Ryder (big blind) folded before Flop
Seat 4: deoxy1909 showed [Jh Ks] and lost with a pair of Kings
Seat 5: <v<Kar1nA>^> folded before Flop (didn't bet)
Seat 6: vagon21 showed [Ah Kd] and won ($1.96) with a pair of Kings



PokerStars Zoom Hand #120947915716:  Hold'em No Limit ($0.01/$0.02) - 2014/09/02 7:51:11 ET
Table 'Halley' 6-max Seat #1 is the button
Seat 1: glamorous_87 ($1 in chips) 
Seat 2: deoxy1909 ($0.85 in chips) 
Seat 3: Kneipen21 ($2.01 in chips) 
Seat 4: astraf89 ($2.15 in chips) 
Seat 5: gollo51 ($1.06 in chips) 
Seat 6: darecripple ($2 in chips) 
deoxy1909: posts small blind $0.01
Kneipen21: posts big blind $0.02
*** HOLE CARDS ***
Dealt to deoxy1909 [Kh 4d]
astraf89: folds 
gollo51: folds 
darecripple: folds 
glamorous_87: calls $0.02
deoxy1909: folds 
Kneipen21: raises $0.03 to $0.05
glamorous_87: calls $0.03
*** FLOP *** [8s 7c Tc]
Kneipen21: bets $0.07
glamorous_87: calls $0.07
*** TURN *** [8s 7c Tc] [Kd]
Kneipen21: checks 
glamorous_87: bets $0.06
Kneipen21: calls $0.06
*** RIVER *** [8s 7c Tc Kd] [6d]
Kneipen21: checks 
glamorous_87: bets $0.12
Kneipen21: calls $0.12
*** SHOW DOWN ***
glamorous_87: shows [4h Jd] (high card King)
Kneipen21: shows [Qd Qh] (a pair of Queens)
Kneipen21 collected $0.59 from pot
*** SUMMARY ***
Total pot $0.61 | Rake $0.02 
Board [8s 7c Tc Kd 6d]
Seat 1: glamorous_87 (button) showed [4h Jd] and lost with high card King
Seat 2: deoxy1909 (small blind) folded before Flop
Seat 3: Kneipen21 (big blind) showed [Qd Qh] and won ($0.59) with a pair of Queens
Seat 4: astraf89 folded before Flop (didn't bet)
Seat 5: gollo51 folded before Flop (didn't bet)
Seat 6: darecripple folded before Flop (didn't bet)



PokerStars Zoom Hand #120947926468:  Hold'em No Limit ($0.01/$0.02) - 2014/09/02 7:51:32 ET
Table 'Halley' 6-max Seat #1 is the button
Seat 1: allrock888 ($1.79 in chips) 
Seat 2: Kneipen21 ($3.23 in chips) 
Seat 3: deoxy1909 ($0.84 in chips) 
Seat 4: andytiby ($2.01 in chips) 
Seat 5: Marigold2510 ($0.90 in chips) 
Seat 6: BobdeNassty ($2.09 in chips) 
Kneipen21: posts small blind $0.01
deoxy1909: posts big blind $0.02
*** HOLE CARDS ***
Dealt to deoxy1909 [Ts 7d]
andytiby: folds 
Marigold2510: calls $0.02
BobdeNassty: calls $0.02
allrock888: folds 
Kneipen21: raises $0.05 to $0.07
deoxy1909: folds 
Marigold2510: folds 
BobdeNassty: calls $0.05
*** FLOP *** [3d 5d 4c]
Kneipen21: bets $0.11
BobdeNassty: calls $0.11
*** TURN *** [3d 5d 4c] [Kd]
Kneipen21: bets $0.25
BobdeNassty: calls $0.25
*** RIVER *** [3d 5d 4c Kd] [5h]
Kneipen21: checks 
BobdeNassty: checks 
*** SHOW DOWN ***
Kneipen21: shows [Th Ad] (a pair of Fives)
BobdeNassty: shows [Ks Ac] (two pair, Kings and Fives)
BobdeNassty collected $0.87 from pot
*** SUMMARY ***
Total pot $0.90 | Rake $0.03 
Board [3d 5d 4c Kd 5h]
Seat 1: allrock888 (button) folded before Flop (didn't bet)
Seat 2: Kneipen21 (small blind) showed [Th Ad] and lost with a pair of Fives
Seat 3: deoxy1909 (big blind) folded before Flop
Seat 4: andytiby folded before Flop (didn't bet)
Seat 5: Marigold2510 folded before Flop
Seat 6: BobdeNassty showed [Ks Ac] and won ($0.87) with two pair, Kings and Fives



PokerStars Zoom Hand #120948148171:  Hold'em No Limit ($0.01/$0.02) - 2014/09/02 7:59:21 ET
Table 'Halley' 6-max Seat #1 is the button
Seat 1: proinzer ($2.24 in chips) 
Seat 2: deoxy1909 ($0.63 in chips) 
Seat 3: Subuk0u ($1.79 in chips) 
Seat 4: trpoker918 ($1.10 in chips) 
Seat 5: Krycuk ($2.37 in chips) 
Seat 6: urbanman101 ($2.20 in chips) 
deoxy1909: posts small blind $0.01
Subuk0u: posts big blind $0.02
*** HOLE CARDS ***
Dealt to deoxy1909 [Th 7c]
trpoker918: raises $0.02 to $0.04
Krycuk: folds 
urbanman101: calls $0.04
proinzer: calls $0.04
deoxy1909: folds 
Subuk0u: folds 
*** FLOP *** [2c 5s Ac]
trpoker918: checks 
urbanman101: checks 
proinzer: bets $0.14
trpoker918: calls $0.14
urbanman101: folds 
*** TURN *** [2c 5s Ac] [Kc]
trpoker918: checks 
proinzer: bets $0.22
trpoker918: calls $0.22
*** RIVER *** [2c 5s Ac Kc] [2s]
trpoker918: bets $0.02
proinzer: calls $0.02
*** SHOW DOWN ***
trpoker918: shows [As Td] (two pair, Aces and Deuces)
proinzer: shows [Ad 8d] (two pair, Aces and Deuces)
trpoker918 collected $0.44 from pot
proinzer collected $0.44 from pot
*** SUMMARY ***
Total pot $0.91 | Rake $0.03 
Board [2c 5s Ac Kc 2s]
Seat 1: proinzer (button) showed [Ad 8d] and won ($0.44) with two pair, Aces and Deuces
Seat 2: deoxy1909 (small blind) folded before Flop
Seat 3: Subuk0u (big blind) folded before Flop
Seat 4: trpoker918 showed [As Td] and won ($0.44) with two pair, Aces and Deuces
Seat 5: Krycuk folded before Flop (didn't bet)
Seat 6: urbanman101 folded on the Flop



PokerStars Zoom Hand #120948227988:  Hold'em No Limit ($0.01/$0.02) - 2014/09/02 8:02:06 ET
Table 'Halley' 6-max Seat #1 is the button
Seat 1: 321Boris321 ($0.60 in chips) 
Seat 2: deoxy1909 ($0.59 in chips) 
Seat 3: VASIA875 ($1.34 in chips) 
Seat 4: cr34kt1v ($1.80 in chips) 
Seat 5: szelik ($0.89 in chips) 
Seat 6: Aratol ($2.68 in chips) 
deoxy1909: posts small blind $0.01
VASIA875: posts big blind $0.02
*** HOLE CARDS ***
Dealt to deoxy1909 [4c 7h]
cr34kt1v: folds 
szelik: raises $0.02 to $0.04
Aratol: folds 
321Boris321: folds 
deoxy1909: folds 
VASIA875: calls $0.02
*** FLOP *** [Ac 3h 3c]
VASIA875: checks 
szelik: bets $0.09
VASIA875: calls $0.09
*** TURN *** [Ac 3h 3c] [4d]
VASIA875: checks 
szelik: bets $0.26
VASIA875: calls $0.26
*** RIVER *** [Ac 3h 3c 4d] [Ks]
VASIA875: checks 
szelik: bets $0.50 and is all-in
VASIA875: calls $0.50
*** SHOW DOWN ***
szelik: shows [Jh 4h] (two pair, Fours and Threes)
VASIA875: shows [Js Ah] (two pair, Aces and Threes)
VASIA875 collected $1.73 from pot
*** SUMMARY ***
Total pot $1.79 | Rake $0.06 
Board [Ac 3h 3c 4d Ks]
Seat 1: 321Boris321 (button) folded before Flop (didn't bet)
Seat 2: deoxy1909 (small blind) folded before Flop
Seat 3: VASIA875 (big blind) showed [Js Ah] and won ($1.73) with two pair, Aces and Threes
Seat 4: cr34kt1v folded before Flop (didn't bet)
Seat 5: szelik showed [Jh 4h] and lost with two pair, Fours and Threes
Seat 6: Aratol folded before Flop (didn't bet)



PokerStars Zoom Hand #120948417996:  Hold'em No Limit ($0.01/$0.02) - 2014/09/02 8:08:03 ET
Table 'Halley' 6-max Seat #1 is the button
Seat 1: BreJohn ($2.68 in chips) 
Seat 2: AndreySV1980 ($0.82 in chips) 
Seat 3: RamStatesman ($1.55 in chips) 
Seat 4: wili777ever ($2.82 in chips) 
Seat 5: deoxy1909 ($0.90 in chips) 
Seat 6: SoHay99 ($2.08 in chips) 
AndreySV1980: posts small blind $0.01
RamStatesman: posts big blind $0.02
*** HOLE CARDS ***
Dealt to deoxy1909 [5h 5s]
wili777ever: folds 
deoxy1909: raises $0.04 to $0.06
SoHay99: calls $0.06
BreJohn: folds 
AndreySV1980: folds 
RamStatesman: calls $0.04
*** FLOP *** [3c 9h 3h]
RamStatesman: checks 
deoxy1909: checks 
SoHay99: checks 
*** TURN *** [3c 9h 3h] [4c]
RamStatesman: bets $0.12
deoxy1909: calls $0.12
SoHay99: calls $0.12
*** RIVER *** [3c 9h 3h 4c] [9s]
RamStatesman: checks 
deoxy1909: bets $0.40
SoHay99: folds 
RamStatesman: folds 
Uncalled bet ($0.40) returned to deoxy1909
deoxy1909 collected $0.53 from pot
deoxy1909: doesn't show hand 
*** SUMMARY ***
Total pot $0.55 | Rake $0.02 
Board [3c 9h 3h 4c 9s]
Seat 1: BreJohn (button) folded before Flop (didn't bet)
Seat 2: AndreySV1980 (small blind) folded before Flop
Seat 3: RamStatesman (big blind) folded on the River
Seat 4: wili777ever folded before Flop (didn't bet)
Seat 5: deoxy1909 collected ($0.53)
Seat 6: SoHay99 folded on the River



PokerStars Zoom Hand #120948501643:  Hold'em No Limit ($0.01/$0.02) - 2014/09/02 8:10:39 ET
Table 'Halley' 6-max Seat #1 is the button
Seat 1: chalanisko ($1.42 in chips) 
Seat 2: Rino Stars ($2.03 in chips) 
Seat 3: mohandes81 ($6.14 in chips) 
Seat 4: deoxy1909 ($1.38 in chips) 
Seat 5: MaceWinduu ($1.03 in chips) 
Seat 6: MC-Sjaak ($4.14 in chips) 
Rino Stars: posts small blind $0.01
mohandes81: posts big blind $0.02
*** HOLE CARDS ***
Dealt to deoxy1909 [Qs Kc]
deoxy1909: raises $0.04 to $0.06
MaceWinduu: folds 
MC-Sjaak: calls $0.06
chalanisko: folds 
Rino Stars: calls $0.05
mohandes81: calls $0.04
*** FLOP *** [Th 5c Qh]
Rino Stars: checks 
mohandes81: bets $0.16
deoxy1909: calls $0.16
MC-Sjaak: folds 
Rino Stars: folds 
*** TURN *** [Th 5c Qh] [5s]
mohandes81: bets $0.36
deoxy1909: raises $0.36 to $0.72
mohandes81: folds 
Uncalled bet ($0.36) returned to deoxy1909
deoxy1909 collected $1.24 from pot
deoxy1909: doesn't show hand 
*** SUMMARY ***
Total pot $1.28 | Rake $0.04 
Board [Th 5c Qh 5s]
Seat 1: chalanisko (button) folded before Flop (didn't bet)
Seat 2: Rino Stars (small blind) folded on the Flop
Seat 3: mohandes81 (big blind) folded on the Turn
Seat 4: deoxy1909 collected ($1.24)
Seat 5: MaceWinduu folded before Flop (didn't bet)
Seat 6: MC-Sjaak folded on the Flop



PokerStars Zoom Hand #120948551067:  Hold'em No Limit ($0.01/$0.02) - 2014/09/02 8:12:12 ET
Table 'Halley' 6-max Seat #1 is the button
Seat 1: glikegenius ($2.95 in chips) 
Seat 2: LCDwish ($4.53 in chips) 
Seat 3: DutchForever ($1.96 in chips) 
Seat 4: bakbakyv777 ($7.21 in chips) 
Seat 5: AHTOCb ($2 in chips) 
Seat 6: deoxy1909 ($2.01 in chips) 
LCDwish: posts small blind $0.01
DutchForever: posts big blind $0.02
*** HOLE CARDS ***
Dealt to deoxy1909 [Ad Ac]
bakbakyv777: calls $0.02
AHTOCb: folds 
deoxy1909: raises $0.06 to $0.08
glikegenius: folds 
LCDwish: folds 
DutchForever: calls $0.06
bakbakyv777: calls $0.06
*** FLOP *** [Th 6h 7s]
DutchForever: checks 
bakbakyv777: checks 
deoxy1909: bets $0.16
DutchForever: folds 
bakbakyv777: raises $0.16 to $0.32
deoxy1909: raises $0.24 to $0.56
bakbakyv777: raises $6.57 to $7.13 and is all-in
deoxy1909: calls $1.37 and is all-in
Uncalled bet ($5.20) returned to bakbakyv777
*** TURN *** [Th 6h 7s] [Ts]
*** RIVER *** [Th 6h 7s Ts] [4d]
*** SHOW DOWN ***
bakbakyv777: shows [7d 7c] (a full house, Sevens full of Tens)
deoxy1909: shows [Ad Ac] (two pair, Aces and Tens)
bakbakyv777 collected $3.97 from pot
*** SUMMARY ***
Total pot $4.11 | Rake $0.14 
Board [Th 6h 7s Ts 4d]
Seat 1: glikegenius (button) folded before Flop (didn't bet)
Seat 2: LCDwish (small blind) folded before Flop
Seat 3: DutchForever (big blind) folded on the Flop
Seat 4: bakbakyv777 showed [7d 7c] and won ($3.97) with a full house, Sevens full of Tens
Seat 5: AHTOCb folded before Flop (didn't bet)
Seat 6: deoxy1909 showed [Ad Ac] and lost with two pair, Aces and Tens



PokerStars Zoom Hand #120948886155:  Hold'em No Limit ($0.01/$0.02) - 2014/09/02 8:22:31 ET
Table 'Halley' 6-max Seat #1 is the button
Seat 1: tomsutch ($2.24 in chips) 
Seat 2: xDre3x ($0.88 in chips) 
Seat 3: deoxy1909 ($1.97 in chips) 
Seat 4: Swil3s ($3 in chips) 
Seat 5: Jorgefss ($2.19 in chips) 
Seat 6: reg_nl2 ($1.58 in chips) 
xDre3x: posts small blind $0.01
deoxy1909: posts big blind $0.02
*** HOLE CARDS ***
Dealt to deoxy1909 [Jd Kd]
Swil3s: folds 
Jorgefss: folds 
reg_nl2: folds 
tomsutch: folds 
xDre3x: calls $0.01
deoxy1909: raises $0.06 to $0.08
xDre3x: calls $0.06
*** FLOP *** [7h Ts Jh]
xDre3x: checks 
deoxy1909: bets $0.10
xDre3x: calls $0.10
*** TURN *** [7h Ts Jh] [Js]
xDre3x: checks 
deoxy1909: bets $0.24
xDre3x: calls $0.24
*** RIVER *** [7h Ts Jh Js] [Jc]
xDre3x: checks 
deoxy1909: bets $0.60
xDre3x: calls $0.46 and is all-in
Uncalled bet ($0.14) returned to deoxy1909
*** SHOW DOWN ***
deoxy1909: shows [Jd Kd] (four of a kind, Jacks)
xDre3x: shows [Kh Tc] (a full house, Jacks full of Tens)
deoxy1909 collected $1.70 from pot
*** SUMMARY ***
Total pot $1.76 | Rake $0.06 
Board [7h Ts Jh Js Jc]
Seat 1: tomsutch (button) folded before Flop (didn't bet)
Seat 2: xDre3x (small blind) showed [Kh Tc] and lost with a full house, Jacks full of Tens
Seat 3: deoxy1909 (big blind) showed [Jd Kd] and won ($1.70) with four of a kind, Jacks
Seat 4: Swil3s folded before Flop (didn't bet)
Seat 5: Jorgefss folded before Flop (didn't bet)
Seat 6: reg_nl2 folded before Flop (didn't bet)



PokerStars Zoom Hand #120949109991:  Hold'em No Limit ($0.01/$0.02) - 2014/09/02 8:29:18 ET
Table 'Halley' 6-max Seat #1 is the button
Seat 1: cricau010 ($1.89 in chips) 
Seat 2: kotbalamut ($8.28 in chips) 
Seat 3: deoxy1909 ($2.88 in chips) 
Seat 4: katal2 ($0.85 in chips) 
Seat 5: lily Ivanova ($3 in chips) 
Seat 6: keffmajster ($3.70 in chips) 
kotbalamut: posts small blind $0.01
deoxy1909: posts big blind $0.02
*** HOLE CARDS ***
Dealt to deoxy1909 [Ah Jd]
katal2: folds 
lily Ivanova: folds 
keffmajster: raises $0.04 to $0.06
cricau010: folds 
kotbalamut: folds 
deoxy1909: calls $0.04
*** FLOP *** [Th 5c 6d]
deoxy1909: checks 
keffmajster: bets $0.08
deoxy1909: calls $0.08
*** TURN *** [Th 5c 6d] [9c]
deoxy1909: checks 
keffmajster: bets $0.18
deoxy1909: calls $0.18
*** RIVER *** [Th 5c 6d 9c] [Kd]
deoxy1909: checks 
keffmajster: bets $0.31
deoxy1909: calls $0.31
*** SHOW DOWN ***
keffmajster: shows [Ac As] (a pair of Aces)
deoxy1909: mucks hand 
keffmajster collected $1.23 from pot
*** SUMMARY ***
Total pot $1.27 | Rake $0.04 
Board [Th 5c 6d 9c Kd]
Seat 1: cricau010 (button) folded before Flop (didn't bet)
Seat 2: kotbalamut (small blind) folded before Flop
Seat 3: deoxy1909 (big blind) mucked [Ah Jd]
Seat 4: katal2 folded before Flop (didn't bet)
Seat 5: lily Ivanova folded before Flop (didn't bet)
Seat 6: keffmajster showed [Ac As] and won ($1.23) with a pair of Aces



PokerStars Zoom Hand #120949479982:  Hold'em No Limit ($0.01/$0.02) - 2014/09/02 8:40:18 ET
Table 'Halley' 6-max Seat #1 is the button
Seat 1: paziTka_kdL ($2.53 in chips) 
Seat 2: deoxy1909 ($2.25 in chips) 
Seat 3: alkse ($1.23 in chips) 
Seat 4: imaginelsd ($0.97 in chips) 
Seat 5: bullof ($4.06 in chips) 
Seat 6: Nigumm ($2.36 in chips) 
deoxy1909: posts small blind $0.01
alkse: posts big blind $0.02
*** HOLE CARDS ***
Dealt to deoxy1909 [Kd Ts]
imaginelsd: folds 
bullof: folds 
Nigumm: folds 
paziTka_kdL: raises $0.04 to $0.06
deoxy1909: folds 
alkse: calls $0.04
*** FLOP *** [8s 4s Qh]
alkse: checks 
paziTka_kdL: bets $0.08
alkse: calls $0.08
*** TURN *** [8s 4s Qh] [9c]
alkse: checks 
paziTka_kdL: bets $0.14
alkse: calls $0.14
*** RIVER *** [8s 4s Qh 9c] [7c]
alkse: checks 
paziTka_kdL: checks 
*** SHOW DOWN ***
alkse: shows [6s 7h] (a pair of Sevens)
paziTka_kdL: shows [Jd Qd] (a pair of Queens)
paziTka_kdL collected $0.55 from pot
*** SUMMARY ***
Total pot $0.57 | Rake $0.02 
Board [8s 4s Qh 9c 7c]
Seat 1: paziTka_kdL (button) showed [Jd Qd] and won ($0.55) with a pair of Queens
Seat 2: deoxy1909 (small blind) folded before Flop
Seat 3: alkse (big blind) showed [6s 7h] and lost with a pair of Sevens
Seat 4: imaginelsd folded before Flop (didn't bet)
Seat 5: bullof folded before Flop (didn't bet)
Seat 6: Nigumm folded before Flop (didn't bet)



PokerStars Zoom Hand #120949525926:  Hold'em No Limit ($0.01/$0.02) - 2014/09/02 8:41:39 ET
Table 'Halley' 6-max Seat #1 is the button
Seat 1: longhair180 ($5.96 in chips) 
Seat 2: deoxy1909 ($2.16 in chips) 
Seat 3: baianai-82 ($1 in chips) 
Seat 4: xmidezzx ($2.29 in chips) 
Seat 5: Sergio37T ($2.41 in chips) 
Seat 6: eliaselgrock ($1.78 in chips) 
deoxy1909: posts small blind $0.01
baianai-82: posts big blind $0.02
*** HOLE CARDS ***
Dealt to deoxy1909 [Kd Ad]
xmidezzx: folds 
Sergio37T: raises $0.04 to $0.06
eliaselgrock: calls $0.06
longhair180: folds 
deoxy1909: raises $0.18 to $0.24
baianai-82: folds 
Sergio37T: calls $0.18
eliaselgrock: calls $0.18
*** FLOP *** [Tc Js As]
deoxy1909: bets $0.54
Sergio37T: folds 
eliaselgrock: calls $0.54
*** TURN *** [Tc Js As] [2h]
deoxy1909: bets $1.34
eliaselgrock: calls $1 and is all-in
Uncalled bet ($0.34) returned to deoxy1909
*** RIVER *** [Tc Js As 2h] [2s]
*** SHOW DOWN ***
deoxy1909: shows [Kd Ad] (two pair, Aces and Deuces)
eliaselgrock: shows [Ks Qs] (a flush, Ace high)
eliaselgrock collected $3.69 from pot
*** SUMMARY ***
Total pot $3.82 | Rake $0.13 
Board [Tc Js As 2h 2s]
Seat 1: longhair180 (button) folded before Flop (didn't bet)
Seat 2: deoxy1909 (small blind) showed [Kd Ad] and lost with two pair, Aces and Deuces
Seat 3: baianai-82 (big blind) folded before Flop
Seat 4: xmidezzx folded before Flop (didn't bet)
Seat 5: Sergio37T folded on the Flop
Seat 6: eliaselgrock showed [Ks Qs] and won ($3.69) with a flush, Ace high



PokerStars Zoom Hand #120949579854:  Hold'em No Limit ($0.01/$0.02) - 2014/09/02 8:43:12 ET
Table 'Halley' 6-max Seat #1 is the button
Seat 1: deoxy1909 ($0.35 in chips) 
Seat 2: pto777 ($3.40 in chips) 
Seat 3: poulo888 ($2.33 in chips) 
Seat 4: urgent24/7 ($2 in chips) 
Seat 5: MrManfromUa ($2.47 in chips) 
Seat 6: siddeburen ($2 in chips) 
pto777: posts small blind $0.01
poulo888: posts big blind $0.02
*** HOLE CARDS ***
Dealt to deoxy1909 [Ac 2s]
urgent24/7: raises $0.04 to $0.06
MrManfromUa: folds 
siddeburen: folds 
deoxy1909: folds 
pto777: calls $0.05
poulo888: folds 
*** FLOP *** [Kc 2h 5h]
pto777: checks 
urgent24/7: bets $0.08
pto777: raises $0.15 to $0.23
urgent24/7: calls $0.15
*** TURN *** [Kc 2h 5h] [8d]
pto777: bets $0.40
urgent24/7: calls $0.40
*** RIVER *** [Kc 2h 5h 8d] [9d]
pto777: checks 
urgent24/7: bets $1.21
pto777: folds 
Uncalled bet ($1.21) returned to urgent24/7
urgent24/7 collected $1.35 from pot
urgent24/7: doesn't show hand 
*** SUMMARY ***
Total pot $1.40 | Rake $0.05 
Board [Kc 2h 5h 8d 9d]
Seat 1: deoxy1909 (button) folded before Flop (didn't bet)
Seat 2: pto777 (small blind) folded on the River
Seat 3: poulo888 (big blind) folded before Flop
Seat 4: urgent24/7 collected ($1.35)
Seat 5: MrManfromUa folded before Flop (didn't bet)
Seat 6: siddeburen folded before Flop (didn't bet)



PokerStars Zoom Hand #120949666601:  Hold'em No Limit ($0.01/$0.02) - 2014/09/02 8:45:40 ET
Table 'Halley' 6-max Seat #1 is the button
Seat 1: deoxy1909 ($0.31 in chips) 
Seat 2: ginsui999 ($2.02 in chips) 
Seat 3: ZhirikNN ($6.29 in chips) 
Seat 4: schmohobo ($2.05 in chips) 
Seat 5: coringa010 ($3.49 in chips) 
Seat 6: ciombitz ($3.96 in chips) 
ginsui999: posts small blind $0.01
ZhirikNN: posts big blind $0.02
*** HOLE CARDS ***
Dealt to deoxy1909 [6s 8s]
schmohobo: folds 
coringa010: folds 
ciombitz: raises $0.03 to $0.05
deoxy1909: folds 
ginsui999: calls $0.04
ZhirikNN: folds 
*** FLOP *** [8d 3d 8h]
ginsui999: bets $0.06
ciombitz: calls $0.06
*** TURN *** [8d 3d 8h] [6c]
ginsui999: bets $0.11
ciombitz: calls $0.11
*** RIVER *** [8d 3d 8h 6c] [9d]
ginsui999: bets $0.22
ciombitz: calls $0.22
*** SHOW DOWN ***
ginsui999: shows [4s As] (a pair of Eights)
ciombitz: shows [Kd Kh] (two pair, Kings and Eights)
ciombitz collected $0.87 from pot
*** SUMMARY ***
Total pot $0.90 | Rake $0.03 
Board [8d 3d 8h 6c 9d]
Seat 1: deoxy1909 (button) folded before Flop (didn't bet)
Seat 2: ginsui999 (small blind) showed [4s As] and lost with a pair of Eights
Seat 3: ZhirikNN (big blind) folded before Flop
Seat 4: schmohobo folded before Flop (didn't bet)
Seat 5: coringa010 folded before Flop (didn't bet)
Seat 6: ciombitz showed [Kd Kh] and won ($0.87) with two pair, Kings and Eights



PokerStars Zoom Hand #120950000364:  Hold'em No Limit ($0.01/$0.02) - 2014/09/02 8:55:07 ET
Table 'Halley' 6-max Seat #1 is the button
Seat 1: javitoruiz ($2 in chips) 
Seat 2: deoxy1909 ($0.26 in chips) 
Seat 3: krestovski ($3.15 in chips) 
Seat 4: gcaramian ($1.44 in chips) 
Seat 5: Dumii213 ($2.32 in chips) 
Seat 6: Dav1dos ($2 in chips) 
deoxy1909: posts small blind $0.01
krestovski: posts big blind $0.02
*** HOLE CARDS ***
Dealt to deoxy1909 [Ah 4s]
gcaramian: folds 
Dumii213 has timed out
Dumii213: folds 
Dav1dos: raises $0.04 to $0.06
javitoruiz: raises $0.09 to $0.15
deoxy1909: folds 
krestovski: folds 
Dav1dos: raises $0.33 to $0.48
javitoruiz: calls $0.33
*** FLOP *** [Jh 4c 6h]
Dav1dos: bets $0.63
javitoruiz: raises $0.89 to $1.52 and is all-in
Dav1dos: calls $0.89 and is all-in
*** FIRST TURN *** [Jh 4c 6h] [7h]
*** FIRST RIVER *** [Jh 4c 6h 7h] [8d]
*** SECOND TURN *** [Jh 4c 6h] [9d]
*** SECOND RIVER *** [Jh 4c 6h 9d] [3c]
*** FIRST SHOW DOWN ***
Dav1dos: shows [Qh Qc] (a pair of Queens)
javitoruiz: shows [6s 6c] (three of a kind, Sixes)
javitoruiz collected $1.95 from pot
*** SECOND SHOW DOWN ***
Dav1dos: shows [Qh Qc] (a pair of Queens)
javitoruiz: shows [6s 6c] (three of a kind, Sixes)
javitoruiz collected $1.94 from pot
*** SUMMARY ***
Total pot $4.03 | Rake $0.14 
Hand was run twice
FIRST Board [Jh 4c 6h 7h 8d]
SECOND Board [Jh 4c 6h 9d 3c]
Seat 1: javitoruiz (button) showed [6s 6c] and won ($1.95) with three of a kind, Sixes, and won ($1.94) with three of a kind, Sixes
Seat 2: deoxy1909 (small blind) folded before Flop
Seat 3: krestovski (big blind) folded before Flop
Seat 4: gcaramian folded before Flop (didn't bet)
Seat 5: Dumii213 folded before Flop (didn't bet)
Seat 6: Dav1dos showed [Qh Qc] and lost with a pair of Queens, and lost with a pair of Queens



PokerStars Zoom Hand #120950167483:  Hold'em No Limit ($0.01/$0.02) - 2014/09/02 9:00:38 ET
Table 'Halley' 6-max Seat #1 is the button
Seat 1: V1olent3R ($2.09 in chips) 
Seat 2: deoxy1909 ($0.21 in chips) 
Seat 3: bhaskarslntv ($1.89 in chips) 
Seat 4: pc168btrx ($2.51 in chips) 
Seat 5: Fitas88 ($2.82 in chips) 
Seat 6: bullof ($6.80 in chips) 
deoxy1909: posts small blind $0.01
bhaskarslntv: posts big blind $0.02
*** HOLE CARDS ***
Dealt to deoxy1909 [4c Qc]
pc168btrx: folds 
Fitas88: folds 
bullof: raises $0.04 to $0.06
V1olent3R: raises $0.12 to $0.18
deoxy1909: folds 
bhaskarslntv: calls $0.16
bullof: calls $0.12
*** FLOP *** [6s 2h 7h]
bhaskarslntv: checks 
bullof: checks 
V1olent3R: bets $0.28
bhaskarslntv: folds 
bullof: raises $6.34 to $6.62 and is all-in
V1olent3R: folds 
Uncalled bet ($6.34) returned to bullof
bullof collected $1.07 from pot
bullof: doesn't show hand 
*** SUMMARY ***
Total pot $1.11 | Rake $0.04 
Board [6s 2h 7h]
Seat 1: V1olent3R (button) folded on the Flop
Seat 2: deoxy1909 (small blind) folded before Flop
Seat 3: bhaskarslntv (big blind) folded on the Flop
Seat 4: pc168btrx folded before Flop (didn't bet)
Seat 5: Fitas88 folded before Flop (didn't bet)
Seat 6: bullof collected ($1.07)



PokerStars Zoom Hand #120950250964:  Hold'em No Limit ($0.01/$0.02) - 2014/09/02 9:02:59 ET
Table 'Halley' 6-max Seat #1 is the button
Seat 1: deoxy1909 ($0.14 in chips) 
Seat 2: V1olent3R ($2.56 in chips) 
Seat 3: PetyaUA ($1.40 in chips) 
Seat 4: JMOchoa92 ($2.06 in chips) 
Seat 5: Himura999 ($2 in chips) 
Seat 6: Graul2013 ($2.49 in chips) 
V1olent3R: posts small blind $0.01
PetyaUA: posts big blind $0.02
*** HOLE CARDS ***
Dealt to deoxy1909 [9h 2h]
JMOchoa92: folds 
Himura999: folds 
Graul2013: folds 
deoxy1909: folds 
V1olent3R: raises $0.04 to $0.06
PetyaUA: calls $0.04
*** FLOP *** [Ts Qh Ad]
V1olent3R: bets $0.06
PetyaUA: raises $0.06 to $0.12
V1olent3R: calls $0.06
*** TURN *** [Ts Qh Ad] [2d]
V1olent3R: checks 
PetyaUA: bets $0.15
V1olent3R: calls $0.15
*** RIVER *** [Ts Qh Ad 2d] [5h]
V1olent3R: checks 
PetyaUA: bets $0.30
V1olent3R: folds 
Uncalled bet ($0.30) returned to PetyaUA
PetyaUA collected $0.64 from pot
PetyaUA: doesn't show hand 
*** SUMMARY ***
Total pot $0.66 | Rake $0.02 
Board [Ts Qh Ad 2d 5h]
Seat 1: deoxy1909 (button) folded before Flop (didn't bet)
Seat 2: V1olent3R (small blind) folded on the River
Seat 3: PetyaUA (big blind) collected ($0.64)
Seat 4: JMOchoa92 folded before Flop (didn't bet)
Seat 5: Himura999 folded before Flop (didn't bet)
Seat 6: Graul2013 folded before Flop (didn't bet)



PokerStars Zoom Hand #120954905841:  Hold'em No Limit ($0.01/$0.02) - 2014/09/02 11:02:14 ET
Table 'Halley' 6-max Seat #1 is the button
Seat 1: sepik200 ($2.17 in chips) 
Seat 2: Filak739 ($4.20 in chips) 
Seat 3: deoxy1909 ($2 in chips) 
Seat 4: incmaster100 ($2.14 in chips) 
Seat 5: Kicmak ($2.75 in chips) 
Seat 6: AAN43 ($4 in chips) 
Filak739: posts small blind $0.01
deoxy1909: posts big blind $0.02
*** HOLE CARDS ***
Dealt to deoxy1909 [3c As]
incmaster100: folds 
Kicmak: raises $0.04 to $0.06
AAN43: calls $0.06
sepik200: calls $0.06
Filak739: calls $0.05
deoxy1909: folds 
*** FLOP *** [5c 5d 4d]
Filak739: bets $0.02
Kicmak: calls $0.02
AAN43: calls $0.02
sepik200: calls $0.02
*** TURN *** [5c 5d 4d] [Jd]
Filak739: folds 
Kicmak: bets $0.33
AAN43: folds 
sepik200: raises $0.33 to $0.66
Kicmak: calls $0.33
*** RIVER *** [5c 5d 4d Jd] [3s]
Kicmak: checks 
sepik200: checks 
*** SHOW DOWN ***
Kicmak: shows [Ks Jc] (two pair, Jacks and Fives)
sepik200: mucks hand 
Kicmak collected $1.60 from pot
*** SUMMARY ***
Total pot $1.66 | Rake $0.06 
Board [5c 5d 4d Jd 3s]
Seat 1: sepik200 (button) mucked [Ad Kc]
Seat 2: Filak739 (small blind) folded on the Turn
Seat 3: deoxy1909 (big blind) folded before Flop
Seat 4: incmaster100 folded before Flop (didn't bet)
Seat 5: Kicmak showed [Ks Jc] and won ($1.60) with two pair, Jacks and Fives
Seat 6: AAN43 folded on the Turn



PokerStars Zoom Hand #120954940104:  Hold'em No Limit ($0.01/$0.02) - 2014/09/02 11:03:03 ET
Table 'Halley' 6-max Seat #1 is the button
Seat 1: DavidVercett ($5.12 in chips) 
Seat 2: Ikkvr ($1.90 in chips) 
Seat 3: dimk00 ($0.86 in chips) 
Seat 4: koki1331 ($2.68 in chips) 
Seat 5: deoxy1909 ($1.97 in chips) 
Seat 6: doctorxah ($2.21 in chips) 
Ikkvr: posts small blind $0.01
dimk00: posts big blind $0.02
*** HOLE CARDS ***
Dealt to deoxy1909 [Kh Ks]
koki1331: folds 
deoxy1909: raises $0.04 to $0.06
doctorxah: folds 
DavidVercett: folds 
Ikkvr: folds 
dimk00: raises $0.10 to $0.16
deoxy1909: raises $0.32 to $0.48
dimk00: calls $0.32
*** FLOP *** [3d Kc 2s]
dimk00: bets $0.38 and is all-in
deoxy1909: calls $0.38
*** FIRST TURN *** [3d Kc 2s] [8h]
*** FIRST RIVER *** [3d Kc 2s 8h] [3s]
*** SECOND TURN *** [3d Kc 2s] [4s]
*** SECOND RIVER *** [3d Kc 2s 4s] [2d]
*** FIRST SHOW DOWN ***
dimk00: shows [Qh Qs] (two pair, Queens and Threes)
deoxy1909: shows [Kh Ks] (a full house, Kings full of Threes)
deoxy1909 collected $0.84 from pot
*** SECOND SHOW DOWN ***
dimk00: shows [Qh Qs] (two pair, Queens and Deuces)
deoxy1909: shows [Kh Ks] (a full house, Kings full of Deuces)
deoxy1909 collected $0.83 from pot
*** SUMMARY ***
Total pot $1.73 | Rake $0.06 
Hand was run twice
FIRST Board [3d Kc 2s 8h 3s]
SECOND Board [3d Kc 2s 4s 2d]
Seat 1: DavidVercett (button) folded before Flop (didn't bet)
Seat 2: Ikkvr (small blind) folded before Flop
Seat 3: dimk00 (big blind) showed [Qh Qs] and lost with two pair, Queens and Threes, and lost with two pair, Queens and Deuces
Seat 4: koki1331 folded before Flop (didn't bet)
Seat 5: deoxy1909 showed [Kh Ks] and won ($0.84) with a full house, Kings full of Threes, and won ($0.83) with a full house, Kings full of Deuces
Seat 6: doctorxah folded before Flop (didn't bet)



PokerStars Zoom Hand #120955013395:  Hold'em No Limit ($0.01/$0.02) - 2014/09/02 11:04:46 ET
Table 'Halley' 6-max Seat #1 is the button
Seat 1: deoxy1909 ($2.70 in chips) 
Seat 2: SYLBART ($0.90 in chips) 
Seat 3: vinc87cze ($2.13 in chips) 
Seat 4: Ana20Raquel ($1.27 in chips) 
Seat 5: UP2ME2WIN27 ($0.77 in chips) 
Seat 6: diamonds410 ($1.25 in chips) 
SYLBART: posts small blind $0.01
vinc87cze: posts big blind $0.02
*** HOLE CARDS ***
Dealt to deoxy1909 [Js Kc]
Ana20Raquel: folds 
UP2ME2WIN27: raises $0.02 to $0.04
diamonds410: calls $0.04
deoxy1909: calls $0.04
SYLBART: calls $0.03
vinc87cze: folds 
*** FLOP *** [5h 7d 7s]
SYLBART: bets $0.02
UP2ME2WIN27: raises $0.02 to $0.04
diamonds410: folds 
deoxy1909: folds 
SYLBART: calls $0.02
*** TURN *** [5h 7d 7s] [4c]
SYLBART: checks 
UP2ME2WIN27: bets $0.02
SYLBART: calls $0.02
*** RIVER *** [5h 7d 7s 4c] [8s]
SYLBART: bets $0.02
UP2ME2WIN27: raises $0.32 to $0.34
SYLBART: calls $0.32
*** SHOW DOWN ***
UP2ME2WIN27: shows [8h 8c] (a full house, Eights full of Sevens)
SYLBART: mucks hand 
UP2ME2WIN27 collected $0.95 from pot
*** SUMMARY ***
Total pot $0.98 | Rake $0.03 
Board [5h 7d 7s 4c 8s]
Seat 1: deoxy1909 (button) folded on the Flop
Seat 2: SYLBART (small blind) mucked [Th Td]
Seat 3: vinc87cze (big blind) folded before Flop
Seat 4: Ana20Raquel folded before Flop (didn't bet)
Seat 5: UP2ME2WIN27 showed [8h 8c] and won ($0.95) with a full house, Eights full of Sevens
Seat 6: diamonds410 folded on the Flop



PokerStars Zoom Hand #120955144646:  Hold'em No Limit ($0.01/$0.02) - 2014/09/02 11:07:49 ET
Table 'Halley' 6-max Seat #1 is the button
Seat 1: deoxy1909 ($2.63 in chips) 
Seat 2: 1dali1 ($0.79 in chips) 
Seat 3: Bugatti789 ($2.18 in chips) 
Seat 4: yeokaje ($2.69 in chips) 
Seat 5: Dengken ($2.34 in chips) 
Seat 6: TIGor77 ($4.70 in chips) 
1dali1: posts small blind $0.01
Bugatti789: posts big blind $0.02
*** HOLE CARDS ***
Dealt to deoxy1909 [Qs 9d]
yeokaje: folds 
Dengken: folds 
TIGor77: folds 
deoxy1909: folds 
1dali1: calls $0.01
Bugatti789: checks 
*** FLOP *** [Jc 5d 4d]
1dali1: bets $0.04
Bugatti789: calls $0.04
*** TURN *** [Jc 5d 4d] [6d]
1dali1: bets $0.06
Bugatti789: calls $0.06
*** RIVER *** [Jc 5d 4d 6d] [6h]
1dali1: bets $0.67 and is all-in
Bugatti789: calls $0.67
*** SHOW DOWN ***
1dali1: shows [As 6s] (three of a kind, Sixes)
Bugatti789: shows [Kd Td] (a flush, King high)
Bugatti789 collected $1.52 from pot
*** SUMMARY ***
Total pot $1.58 | Rake $0.06 
Board [Jc 5d 4d 6d 6h]
Seat 1: deoxy1909 (button) folded before Flop (didn't bet)
Seat 2: 1dali1 (small blind) showed [As 6s] and lost with three of a kind, Sixes
Seat 3: Bugatti789 (big blind) showed [Kd Td] and won ($1.52) with a flush, King high
Seat 4: yeokaje folded before Flop (didn't bet)
Seat 5: Dengken folded before Flop (didn't bet)
Seat 6: TIGor77 folded before Flop (didn't bet)



PokerStars Zoom Hand #120955171696:  Hold'em No Limit ($0.01/$0.02) - 2014/09/02 11:08:27 ET
Table 'Halley' 6-max Seat #1 is the button
Seat 1: koncilij ($2.24 in chips) 
Seat 2: deoxy1909 ($2.66 in chips) 
Seat 3: stric007 ($1.21 in chips) 
Seat 4: mindaugas177 ($2.90 in chips) 
Seat 5: alex197310 ($1 in chips) 
Seat 6: BOL7878 ($4.88 in chips) 
deoxy1909: posts small blind $0.01
stric007: posts big blind $0.02
*** HOLE CARDS ***
Dealt to deoxy1909 [Td 5s]
mindaugas177: raises $0.04 to $0.06
alex197310: folds 
BOL7878: raises $0.06 to $0.12
koncilij: folds 
deoxy1909: folds 
stric007: calls $0.10
mindaugas177: calls $0.06
*** FLOP *** [6s 6c Qh]
stric007: checks 
mindaugas177: checks 
BOL7878: bets $0.36
stric007: raises $0.73 to $1.09 and is all-in
mindaugas177: folds 
BOL7878: calls $0.73
*** TURN *** [6s 6c Qh] [Jd]
*** RIVER *** [6s 6c Qh Jd] [7s]
*** SHOW DOWN ***
stric007: shows [4d 6d] (three of a kind, Sixes)
BOL7878: shows [Ac As] (two pair, Aces and Sixes)
stric007 collected $2.46 from pot
*** SUMMARY ***
Total pot $2.55 | Rake $0.09 
Board [6s 6c Qh Jd 7s]
Seat 1: koncilij (button) folded before Flop (didn't bet)
Seat 2: deoxy1909 (small blind) folded before Flop
Seat 3: stric007 (big blind) showed [4d 6d] and won ($2.46) with three of a kind, Sixes
Seat 4: mindaugas177 folded on the Flop
Seat 5: alex197310 folded before Flop (didn't bet)
Seat 6: BOL7878 showed [Ac As] and lost with two pair, Aces and Sixes



PokerStars Zoom Hand #120955207581:  Hold'em No Limit ($0.01/$0.02) - 2014/09/02 11:09:17 ET
Table 'Halley' 6-max Seat #1 is the button
Seat 1: alopina ($0.97 in chips) 
Seat 2: Ungalawalla ($1.40 in chips) 
Seat 3: AlexBazh ($2.60 in chips) 
Seat 4: mahmud787 ($3.02 in chips) 
Seat 5: deoxy1909 ($2.63 in chips) 
Seat 6: Bugatti789 ($2 in chips) 
Ungalawalla: posts small blind $0.01
AlexBazh: posts big blind $0.02
*** HOLE CARDS ***
Dealt to deoxy1909 [Ks Qc]
mahmud787: raises $0.04 to $0.06
deoxy1909: calls $0.06
Bugatti789: folds 
alopina: calls $0.06
Ungalawalla: folds 
AlexBazh: calls $0.04
*** FLOP *** [Ah Jh 4h]
AlexBazh: bets $0.12
mahmud787: folds 
deoxy1909: folds 
alopina: calls $0.12
*** TURN *** [Ah Jh 4h] [2s]
AlexBazh: bets $0.14
alopina: calls $0.14
*** RIVER *** [Ah Jh 4h 2s] [Jd]
AlexBazh: bets $0.49
alopina: calls $0.49
*** SHOW DOWN ***
AlexBazh: shows [Qh Js] (three of a kind, Jacks)
alopina: mucks hand 
AlexBazh collected $1.69 from pot
*** SUMMARY ***
Total pot $1.75 | Rake $0.06 
Board [Ah Jh 4h 2s Jd]
Seat 1: alopina (button) mucked [As Th]
Seat 2: Ungalawalla (small blind) folded before Flop
Seat 3: AlexBazh (big blind) showed [Qh Js] and won ($1.69) with three of a kind, Jacks
Seat 4: mahmud787 folded on the Flop
Seat 5: deoxy1909 folded on the Flop
Seat 6: Bugatti789 folded before Flop (didn't bet)



PokerStars Zoom Hand #120955275991:  Hold'em No Limit ($0.01/$0.02) - 2014/09/02 11:10:53 ET
Table 'Halley' 6-max Seat #1 is the button
Seat 1: gloomy57 ($2.81 in chips) 
Seat 2: hbxtzc ($0.88 in chips) 
Seat 3: deoxy1909 ($2.51 in chips) 
Seat 4: karpiczek ($2.39 in chips) 
Seat 5: VxAxV ($4.12 in chips) 
Seat 6: DavidVercett ($2.04 in chips) 
hbxtzc: posts small blind $0.01
deoxy1909: posts big blind $0.02
*** HOLE CARDS ***
Dealt to deoxy1909 [9d 6c]
karpiczek: folds 
VxAxV: folds 
DavidVercett: folds 
gloomy57: raises $0.03 to $0.05
hbxtzc: calls $0.04
deoxy1909: folds 
*** FLOP *** [4c 5s 7c]
hbxtzc: bets $0.06
gloomy57: calls $0.06
*** TURN *** [4c 5s 7c] [5c]
hbxtzc: bets $0.11
gloomy57: raises $0.14 to $0.25
hbxtzc: calls $0.14
*** RIVER *** [4c 5s 7c 5c] [6d]
hbxtzc: bets $0.52 and is all-in
gloomy57: folds 
Uncalled bet ($0.52) returned to hbxtzc
hbxtzc collected $0.71 from pot
hbxtzc: doesn't show hand 
*** SUMMARY ***
Total pot $0.74 | Rake $0.03 
Board [4c 5s 7c 5c 6d]
Seat 1: gloomy57 (button) folded on the River
Seat 2: hbxtzc (small blind) collected ($0.71)
Seat 3: deoxy1909 (big blind) folded before Flop
Seat 4: karpiczek folded before Flop (didn't bet)
Seat 5: VxAxV folded before Flop (didn't bet)
Seat 6: DavidVercett folded before Flop (didn't bet)



PokerStars Zoom Hand #120955285469:  Hold'em No Limit ($0.01/$0.02) - 2014/09/02 11:11:06 ET
Table 'Halley' 6-max Seat #1 is the button
Seat 1: baramygina ($4.02 in chips) 
Seat 2: deoxy1909 ($2.49 in chips) 
Seat 3: laino ($2 in chips) 
Seat 4: Devi1Rigo11 ($2.61 in chips) 
Seat 5: wangxi001949 ($3.48 in chips) 
Seat 6: diddyiphone ($4.35 in chips) 
deoxy1909: posts small blind $0.01
laino: posts big blind $0.02
*** HOLE CARDS ***
Dealt to deoxy1909 [Qh 7s]
Devi1Rigo11: folds 
wangxi001949: folds 
diddyiphone: raises $0.02 to $0.04
baramygina: raises $0.02 to $0.06
deoxy1909: folds 
laino: calls $0.04
diddyiphone: calls $0.02
*** FLOP *** [6s 5h Kh]
laino: checks 
diddyiphone: bets $0.32
baramygina: calls $0.32
laino: folds 
*** TURN *** [6s 5h Kh] [3s]
diddyiphone: bets $0.30
baramygina: calls $0.30
*** RIVER *** [6s 5h Kh 3s] [4d]
diddyiphone: checks 
baramygina: bets $1.22
diddyiphone: calls $1.22
*** SHOW DOWN ***
baramygina: shows [Th 7h] (a straight, Three to Seven)
diddyiphone: mucks hand 
baramygina collected $3.73 from pot
*** SUMMARY ***
Total pot $3.87 | Rake $0.14 
Board [6s 5h Kh 3s 4d]
Seat 1: baramygina (button) showed [Th 7h] and won ($3.73) with a straight, Three to Seven
Seat 2: deoxy1909 (small blind) folded before Flop
Seat 3: laino (big blind) folded on the Flop
Seat 4: Devi1Rigo11 folded before Flop (didn't bet)
Seat 5: wangxi001949 folded before Flop (didn't bet)
Seat 6: diddyiphone mucked [6c 2d]



PokerStars Zoom Hand #120955423924:  Hold'em No Limit ($0.01/$0.02) - 2014/09/02 11:14:21 ET
Table 'Halley' 6-max Seat #1 is the button
Seat 1: siddeburen ($4.27 in chips) 
Seat 2: deoxy1909 ($2.45 in chips) 
Seat 3: bouncg ($1.22 in chips) 
Seat 4: KAtomKA ($3.91 in chips) 
Seat 5: Aknifeking ($2.04 in chips) 
Seat 6: forgo0913 ($2.40 in chips) 
deoxy1909: posts small blind $0.01
bouncg: posts big blind $0.02
*** HOLE CARDS ***
Dealt to deoxy1909 [As 5d]
KAtomKA: folds 
Aknifeking: raises $0.04 to $0.06
forgo0913: calls $0.06
siddeburen: folds 
deoxy1909: folds 
bouncg: calls $0.04
*** FLOP *** [8d 6s 5h]
bouncg: checks 
Aknifeking: bets $0.14
forgo0913: calls $0.14
bouncg: folds 
*** TURN *** [8d 6s 5h] [7d]
Aknifeking: checks 
forgo0913: checks 
*** RIVER *** [8d 6s 5h 7d] [5c]
Aknifeking: checks 
forgo0913: bets $0.20
Aknifeking: calls $0.20
*** SHOW DOWN ***
forgo0913: shows [9s 9h] (a straight, Five to Nine)
Aknifeking: mucks hand 
forgo0913 collected $0.84 from pot
*** SUMMARY ***
Total pot $0.87 | Rake $0.03 
Board [8d 6s 5h 7d 5c]
Seat 1: siddeburen (button) folded before Flop (didn't bet)
Seat 2: deoxy1909 (small blind) folded before Flop
Seat 3: bouncg (big blind) folded on the Flop
Seat 4: KAtomKA folded before Flop (didn't bet)
Seat 5: Aknifeking mucked [Qh Qd]
Seat 6: forgo0913 showed [9s 9h] and won ($0.84) with a straight, Five to Nine



PokerStars Zoom Hand #120955494807:  Hold'em No Limit ($0.01/$0.02) - 2014/09/02 11:15:59 ET
Table 'Halley' 6-max Seat #1 is the button
Seat 1: memoryyou ($1.97 in chips) 
Seat 2: DavidVercett ($2 in chips) 
Seat 3: taiena ($2.17 in chips) 
Seat 4: Bugatti789 ($2.25 in chips) 
Seat 5: deoxy1909 ($2.40 in chips) 
Seat 6: koksEX ($1.86 in chips) 
DavidVercett: posts small blind $0.01
taiena: posts big blind $0.02
*** HOLE CARDS ***
Dealt to deoxy1909 [9s 9d]
Bugatti789: folds 
deoxy1909: raises $0.04 to $0.06
koksEX: folds 
memoryyou: calls $0.06
DavidVercett: folds 
taiena: folds 
*** FLOP *** [4s Jh 3d]
deoxy1909: bets $0.10
memoryyou: calls $0.10
*** TURN *** [4s Jh 3d] [6c]
deoxy1909: bets $0.24
memoryyou: calls $0.24
*** RIVER *** [4s Jh 3d 6c] [5h]
deoxy1909: checks 
memoryyou: bets $0.72
deoxy1909: calls $0.72
*** SHOW DOWN ***
memoryyou: shows [Qc Ks] (high card King)
deoxy1909: shows [9s 9d] (a pair of Nines)
deoxy1909 collected $2.19 from pot
*** SUMMARY ***
Total pot $2.27 | Rake $0.08 
Board [4s Jh 3d 6c 5h]
Seat 1: memoryyou (button) showed [Qc Ks] and lost with high card King
Seat 2: DavidVercett (small blind) folded before Flop
Seat 3: taiena (big blind) folded before Flop
Seat 4: Bugatti789 folded before Flop (didn't bet)
Seat 5: deoxy1909 showed [9s 9d] and won ($2.19) with a pair of Nines
Seat 6: koksEX folded before Flop (didn't bet)



PokerStars Zoom Hand #120955539271:  Hold'em No Limit ($0.01/$0.02) - 2014/09/02 11:17:00 ET
Table 'Halley' 6-max Seat #1 is the button
Seat 1: suddjal2 ($1.32 in chips) 
Seat 2: vey tu ($2.29 in chips) 
Seat 3: deoxy1909 ($3.63 in chips) 
Seat 4: Stanislavleg ($2.46 in chips) 
Seat 5: AA GoodLuck ($2.07 in chips) 
Seat 6: koksEX ($1.91 in chips) 
vey tu: posts small blind $0.01
deoxy1909: posts big blind $0.02
*** HOLE CARDS ***
Dealt to deoxy1909 [2d 2h]
Stanislavleg: folds 
AA GoodLuck: folds 
koksEX: raises $0.04 to $0.06
suddjal2: calls $0.06
vey tu: folds 
deoxy1909: calls $0.04
*** FLOP *** [6d Td 2s]
deoxy1909: bets $0.12
koksEX: raises $0.16 to $0.28
suddjal2: calls $0.28
deoxy1909: raises $0.40 to $0.68
koksEX: folds 
suddjal2: raises $0.40 to $1.08
deoxy1909: raises $1.92 to $3
suddjal2: calls $0.18 and is all-in
Uncalled bet ($1.74) returned to deoxy1909
*** TURN *** [6d Td 2s] [Ah]
*** RIVER *** [6d Td 2s Ah] [Qc]
*** SHOW DOWN ***
deoxy1909: shows [2d 2h] (three of a kind, Deuces)
suddjal2: shows [6h Ad] (two pair, Aces and Sixes)
deoxy1909 collected $2.89 from pot
*** SUMMARY ***
Total pot $2.99 | Rake $0.10 
Board [6d Td 2s Ah Qc]
Seat 1: suddjal2 (button) showed [6h Ad] and lost with two pair, Aces and Sixes
Seat 2: vey tu (small blind) folded before Flop
Seat 3: deoxy1909 (big blind) showed [2d 2h] and won ($2.89) with three of a kind, Deuces
Seat 4: Stanislavleg folded before Flop (didn't bet)
Seat 5: AA GoodLuck folded before Flop (didn't bet)
Seat 6: koksEX folded on the Flop



PokerStars Zoom Hand #120955861497:  Hold'em No Limit ($0.01/$0.02) - 2014/09/02 11:24:22 ET
Table 'Halley' 6-max Seat #1 is the button
Seat 1: deoxy1909 ($1.96 in chips) 
Seat 2: taramokh ($2.04 in chips) 
Seat 3: VxAxV ($4.72 in chips) 
Seat 4: Kuztoi ($1.91 in chips) 
Seat 5: D-AC. Milan ($2 in chips) 
Seat 6: bich74 ($3.37 in chips) 
taramokh: posts small blind $0.01
VxAxV: posts big blind $0.02
*** HOLE CARDS ***
Dealt to deoxy1909 [Kh Qd]
Kuztoi: raises $0.04 to $0.06
D-AC. Milan: folds 
bich74: calls $0.06
deoxy1909: calls $0.06
taramokh: folds 
VxAxV: folds 
*** FLOP *** [Tc 6d 7c]
Kuztoi: checks 
bich74: bets $0.04
deoxy1909: folds 
Kuztoi: calls $0.04
*** TURN *** [Tc 6d 7c] [9c]
Kuztoi: checks 
bich74: checks 
*** RIVER *** [Tc 6d 7c 9c] [Qc]
Kuztoi: bets $0.12
bich74: raises $0.12 to $0.24
Kuztoi: calls $0.12
*** SHOW DOWN ***
bich74: shows [Ac 5c] (a flush, Ace high)
Kuztoi: mucks hand 
bich74 collected $0.74 from pot
*** SUMMARY ***
Total pot $0.77 | Rake $0.03 
Board [Tc 6d 7c 9c Qc]
Seat 1: deoxy1909 (button) folded on the Flop
Seat 2: taramokh (small blind) folded before Flop
Seat 3: VxAxV (big blind) folded before Flop
Seat 4: Kuztoi mucked [As Jc]
Seat 5: D-AC. Milan folded before Flop (didn't bet)
Seat 6: bich74 showed [Ac 5c] and won ($0.74) with a flush, Ace high



PokerStars Zoom Hand #120955959407:  Hold'em No Limit ($0.01/$0.02) - 2014/09/02 11:26:37 ET
Table 'Halley' 6-max Seat #1 is the button
Seat 1: deoxy1909 ($1.79 in chips) 
Seat 2: AndreyRBS ($1.58 in chips) 
Seat 3: junkt ($1.40 in chips) 
Seat 4: NapSnaky ($4.07 in chips) 
Seat 5: Gregy86 ($2.03 in chips) 
Seat 6: H3PL ($2.28 in chips) 
AndreyRBS: posts small blind $0.01
junkt: posts big blind $0.02
*** HOLE CARDS ***
Dealt to deoxy1909 [2s 5c]
NapSnaky: folds 
Gregy86: raises $0.03 to $0.05
H3PL: folds 
deoxy1909: folds 
AndreyRBS: folds 
junkt: calls $0.03
*** FLOP *** [6h Ac 9c]
junkt: checks 
Gregy86: bets $0.07
junkt: calls $0.07
*** TURN *** [6h Ac 9c] [6s]
junkt: checks 
Gregy86: bets $0.15
junkt: calls $0.15
*** RIVER *** [6h Ac 9c 6s] [8s]
junkt: checks 
Gregy86: checks 
*** SHOW DOWN ***
junkt: shows [7s Ah] (two pair, Aces and Sixes)
Gregy86: mucks hand 
junkt collected $0.53 from pot
*** SUMMARY ***
Total pot $0.55 | Rake $0.02 
Board [6h Ac 9c 6s 8s]
Seat 1: deoxy1909 (button) folded before Flop (didn't bet)
Seat 2: AndreyRBS (small blind) folded before Flop
Seat 3: junkt (big blind) showed [7s Ah] and won ($0.53) with two pair, Aces and Sixes
Seat 4: NapSnaky folded before Flop (didn't bet)
Seat 5: Gregy86 mucked [8d 9d]
Seat 6: H3PL folded before Flop (didn't bet)



PokerStars Zoom Hand #120956149178:  Hold'em No Limit ($0.01/$0.02) - 2014/09/02 11:30:59 ET
Table 'Halley' 6-max Seat #1 is the button
Seat 1: VxAxV ($4.39 in chips) 
Seat 2: Allech ($1.72 in chips) 
Seat 3: deoxy1909 ($1.60 in chips) 
Seat 4: Bugatti789 ($4.22 in chips) 
Seat 5: beliy_poker ($3.53 in chips) 
Seat 6: shogi999 ($2.93 in chips) 
Allech: posts small blind $0.01
deoxy1909: posts big blind $0.02
*** HOLE CARDS ***
Dealt to deoxy1909 [8c 8s]
Bugatti789: calls $0.02
beliy_poker: folds 
shogi999: folds 
VxAxV: raises $0.04 to $0.06
Allech: calls $0.05
deoxy1909: calls $0.04
Bugatti789: calls $0.04
*** FLOP *** [Js Ad Qh]
Allech: checks 
deoxy1909: checks 
Bugatti789: bets $0.04
VxAxV: calls $0.04
Allech: calls $0.04
deoxy1909: folds 
*** TURN *** [Js Ad Qh] [9s]
Allech: checks 
Bugatti789: checks 
VxAxV: checks 
*** RIVER *** [Js Ad Qh 9s] [6c]
Allech: checks 
Bugatti789: bets $0.06
VxAxV: calls $0.06
Allech: calls $0.06
*** SHOW DOWN ***
Bugatti789: shows [As Qs] (two pair, Aces and Queens)
VxAxV: mucks hand 
Allech: shows [Ac Kd] (a pair of Aces)
Bugatti789 collected $0.52 from pot
*** SUMMARY ***
Total pot $0.54 | Rake $0.02 
Board [Js Ad Qh 9s 6c]
Seat 1: VxAxV (button) mucked [2h Ah]
Seat 2: Allech (small blind) showed [Ac Kd] and lost with a pair of Aces
Seat 3: deoxy1909 (big blind) folded on the Flop
Seat 4: Bugatti789 showed [As Qs] and won ($0.52) with two pair, Aces and Queens
Seat 5: beliy_poker folded before Flop (didn't bet)
Seat 6: shogi999 folded before Flop (didn't bet)



PokerStars Zoom Hand #120956279370:  Hold'em No Limit ($0.01/$0.02) - 2014/09/02 11:33:57 ET
Table 'Halley' 6-max Seat #1 is the button
Seat 1: deoxy1909 ($1.66 in chips) 
Seat 2: Nonosha ($2.61 in chips) 
Seat 3: dankarys ($2.20 in chips) 
Seat 4: NapSnaky ($3.22 in chips) 
Seat 5: sheckin ($2.03 in chips) 
Seat 6: jwl467835305 ($1.83 in chips) 
Nonosha: posts small blind $0.01
dankarys: posts big blind $0.02
*** HOLE CARDS ***
Dealt to deoxy1909 [Ac 6d]
NapSnaky: folds 
sheckin: folds 
jwl467835305: folds 
deoxy1909: folds 
Nonosha: raises $0.04 to $0.06
dankarys: calls $0.04
*** FLOP *** [9s Ah 4h]
Nonosha: bets $0.07
dankarys: calls $0.07
*** TURN *** [9s Ah 4h] [Ts]
Nonosha: bets $0.20
dankarys: calls $0.20
*** RIVER *** [9s Ah 4h Ts] [Js]
Nonosha: bets $0.96
dankarys: calls $0.96
*** SHOW DOWN ***
Nonosha: shows [7s 6s] (a flush, Jack high)
dankarys: mucks hand 
Nonosha collected $2.49 from pot
*** SUMMARY ***
Total pot $2.58 | Rake $0.09 
Board [9s Ah 4h Ts Js]
Seat 1: deoxy1909 (button) folded before Flop (didn't bet)
Seat 2: Nonosha (small blind) showed [7s 6s] and won ($2.49) with a flush, Jack high
Seat 3: dankarys (big blind) mucked [9c 4s]
Seat 4: NapSnaky folded before Flop (didn't bet)
Seat 5: sheckin folded before Flop (didn't bet)
Seat 6: jwl467835305 folded before Flop (didn't bet)



PokerStars Zoom Hand #120956322908:  Hold'em No Limit ($0.01/$0.02) - 2014/09/02 11:34:56 ET
Table 'Halley' 6-max Seat #1 is the button
Seat 1: deoxy1909 ($1.55 in chips) 
Seat 2: GL16 ($1.98 in chips) 
Seat 3: hoobiwan ($2.07 in chips) 
Seat 4: JerYbinho ($2.61 in chips) 
Seat 5: metti2178 ($4.44 in chips) 
Seat 6: Cap Nemo2011 ($1.60 in chips) 
GL16: posts small blind $0.01
hoobiwan: posts big blind $0.02
*** HOLE CARDS ***
Dealt to deoxy1909 [6c Td]
JerYbinho: calls $0.02
metti2178: raises $4.42 to $4.44 and is all-in
Cap Nemo2011: folds 
deoxy1909: folds 
GL16: folds 
hoobiwan is disconnected 
hoobiwan is connected 
hoobiwan: folds 
JerYbinho: calls $2.59 and is all-in
Uncalled bet ($1.83) returned to metti2178
*** FLOP *** [6s 6h 5h]
*** TURN *** [6s 6h 5h] [9d]
*** RIVER *** [6s 6h 5h 9d] [2s]
*** SHOW DOWN ***
JerYbinho: shows [As Ad] (two pair, Aces and Sixes)
metti2178: shows [Kd Kh] (two pair, Kings and Sixes)
JerYbinho collected $5.07 from pot
*** SUMMARY ***
Total pot $5.25 | Rake $0.18 
Board [6s 6h 5h 9d 2s]
Seat 1: deoxy1909 (button) folded before Flop (didn't bet)
Seat 2: GL16 (small blind) folded before Flop
Seat 3: hoobiwan (big blind) folded before Flop
Seat 4: JerYbinho showed [As Ad] and won ($5.07) with two pair, Aces and Sixes
Seat 5: metti2178 showed [Kd Kh] and lost with two pair, Kings and Sixes
Seat 6: Cap Nemo2011 folded before Flop (didn't bet)



PokerStars Zoom Hand #120956339833:  Hold'em No Limit ($0.01/$0.02) - 2014/09/02 11:35:19 ET
Table 'Halley' 6-max Seat #1 is the button
Seat 1: Zhanben ($3.80 in chips) 
Seat 2: deoxy1909 ($1.53 in chips) 
Seat 3: Willy222444 ($3.22 in chips) 
Seat 4: beliy_poker ($6.27 in chips) 
Seat 5: Johny437 ($5.09 in chips) 
Seat 6: realistik1 ($3.03 in chips) 
deoxy1909: posts small blind $0.01
Willy222444: posts big blind $0.02
*** HOLE CARDS ***
Dealt to deoxy1909 [4c 6h]
beliy_poker: folds 
Johny437: raises $0.06 to $0.08
realistik1: calls $0.08
Zhanben: folds 
deoxy1909: folds 
Willy222444: calls $0.06
*** FLOP *** [Ts 3h 7c]
Willy222444: checks 
Johny437: bets $0.18
realistik1: calls $0.18
Willy222444: folds 
*** TURN *** [Ts 3h 7c] [As]
Johny437: checks 
realistik1: bets $0.25
Johny437: calls $0.25
*** RIVER *** [Ts 3h 7c As] [4d]
Johny437: checks 
realistik1: checks 
*** SHOW DOWN ***
Johny437: shows [Qd Qh] (a pair of Queens)
realistik1: shows [Ah Kd] (a pair of Aces)
realistik1 collected $1.07 from pot
*** SUMMARY ***
Total pot $1.11 | Rake $0.04 
Board [Ts 3h 7c As 4d]
Seat 1: Zhanben (button) folded before Flop (didn't bet)
Seat 2: deoxy1909 (small blind) folded before Flop
Seat 3: Willy222444 (big blind) folded on the Flop
Seat 4: beliy_poker folded before Flop (didn't bet)
Seat 5: Johny437 showed [Qd Qh] and lost with a pair of Queens
Seat 6: realistik1 showed [Ah Kd] and won ($1.07) with a pair of Aces



PokerStars Zoom Hand #120956418105:  Hold'em No Limit ($0.01/$0.02) - 2014/09/02 11:37:05 ET
Table 'Halley' 6-max Seat #1 is the button
Seat 1: deoxy1909 ($1.37 in chips) 
Seat 2: SeRge832 ($2.27 in chips) 
Seat 3: Simkooo ($4.08 in chips) 
Seat 4: TITANnvkz ($2 in chips) 
Seat 5: TRHTANK1 ($3.09 in chips) 
Seat 6: rimus_ooo ($1.94 in chips) 
SeRge832: posts small blind $0.01
Simkooo: posts big blind $0.02
*** HOLE CARDS ***
Dealt to deoxy1909 [5h As]
TITANnvkz: folds 
TRHTANK1: raises $0.04 to $0.06
rimus_ooo: folds 
deoxy1909: folds 
SeRge832: folds 
Simkooo: raises $0.16 to $0.22
TRHTANK1: calls $0.16
*** FLOP *** [Ks Tc 3c]
Simkooo: bets $0.15
TRHTANK1: calls $0.15
*** TURN *** [Ks Tc 3c] [Js]
Simkooo: bets $0.21
TRHTANK1: calls $0.21
*** RIVER *** [Ks Tc 3c Js] [7h]
Simkooo: checks 
TRHTANK1: bets $0.80
Simkooo: folds 
Uncalled bet ($0.80) returned to TRHTANK1
TRHTANK1 collected $1.13 from pot
TRHTANK1: doesn't show hand 
*** SUMMARY ***
Total pot $1.17 | Rake $0.04 
Board [Ks Tc 3c Js 7h]
Seat 1: deoxy1909 (button) folded before Flop (didn't bet)
Seat 2: SeRge832 (small blind) folded before Flop
Seat 3: Simkooo (big blind) folded on the River
Seat 4: TITANnvkz folded before Flop (didn't bet)
Seat 5: TRHTANK1 collected ($1.13)
Seat 6: rimus_ooo folded before Flop (didn't bet)



PokerStars Zoom Hand #120956682776:  Hold'em No Limit ($0.01/$0.02) - 2014/09/02 11:43:04 ET
Table 'Halley' 6-max Seat #1 is the button
Seat 1: Ol'dirty1234 ($1.45 in chips) 
Seat 2: deoxy1909 ($1.14 in chips) 
Seat 3: kevintiger ($2.28 in chips) 
Seat 4: koanajimi ($2.17 in chips) 
Seat 5: lizn ($2.14 in chips) 
Seat 6: AlletaOcean ($2.24 in chips) 
deoxy1909: posts small blind $0.01
kevintiger: posts big blind $0.02
*** HOLE CARDS ***
Dealt to deoxy1909 [Jd 5h]
koanajimi: raises $0.04 to $0.06
lizn: calls $0.06
AlletaOcean: folds 
Ol'dirty1234: calls $0.06
deoxy1909: folds 
kevintiger: folds 
*** FLOP *** [7s 4s Qd]
koanajimi: bets $0.13
lizn: folds 
Ol'dirty1234: calls $0.13
*** TURN *** [7s 4s Qd] [4h]
koanajimi: bets $0.29
Ol'dirty1234: calls $0.29
*** RIVER *** [7s 4s Qd 4h] [6c]
koanajimi: checks 
Ol'dirty1234: checks 
*** SHOW DOWN ***
koanajimi: shows [Ad 7d] (two pair, Sevens and Fours)
Ol'dirty1234: shows [Qh Th] (two pair, Queens and Fours)
Ol'dirty1234 collected $1.01 from pot
*** SUMMARY ***
Total pot $1.05 | Rake $0.04 
Board [7s 4s Qd 4h 6c]
Seat 1: Ol'dirty1234 (button) showed [Qh Th] and won ($1.01) with two pair, Queens and Fours
Seat 2: deoxy1909 (small blind) folded before Flop
Seat 3: kevintiger (big blind) folded before Flop
Seat 4: koanajimi showed [Ad 7d] and lost with two pair, Sevens and Fours
Seat 5: lizn folded on the Flop
Seat 6: AlletaOcean folded before Flop (didn't bet)



PokerStars Zoom Hand #120956708583:  Hold'em No Limit ($0.01/$0.02) - 2014/09/02 11:43:39 ET
Table 'Halley' 6-max Seat #1 is the button
Seat 1: deoxy1909 ($1.07 in chips) 
Seat 2: JimBeamJim ($2.13 in chips) 
Seat 3: kotbalamut ($4.60 in chips) 
Seat 4: deepbg ($1.85 in chips) 
Seat 5: EliteS1987 ($1.77 in chips) 
Seat 6: ionut8770 ($1.75 in chips) 
JimBeamJim: posts small blind $0.01
kotbalamut: posts big blind $0.02
*** HOLE CARDS ***
Dealt to deoxy1909 [9h Kc]
deepbg: raises $0.04 to $0.06
EliteS1987: folds 
ionut8770: calls $0.06
deoxy1909: folds 
JimBeamJim: folds 
kotbalamut: folds 
*** FLOP *** [Ks Jc Qd]
deepbg: checks 
ionut8770: checks 
*** TURN *** [Ks Jc Qd] [7c]
deepbg: bets $0.08
ionut8770: raises $0.08 to $0.16
deepbg: calls $0.08
*** RIVER *** [Ks Jc Qd 7c] [2d]
deepbg: checks 
ionut8770: bets $0.34
deepbg: calls $0.34
*** SHOW DOWN ***
ionut8770: shows [7h Kh] (two pair, Kings and Sevens)
deepbg: mucks hand 
ionut8770 collected $1.11 from pot
*** SUMMARY ***
Total pot $1.15 | Rake $0.04 
Board [Ks Jc Qd 7c 2d]
Seat 1: deoxy1909 (button) folded before Flop (didn't bet)
Seat 2: JimBeamJim (small blind) folded before Flop
Seat 3: kotbalamut (big blind) folded before Flop
Seat 4: deepbg mucked [Qs Ac]
Seat 5: EliteS1987 folded before Flop (didn't bet)
Seat 6: ionut8770 showed [7h Kh] and won ($1.11) with two pair, Kings and Sevens



PokerStars Zoom Hand #120956853695:  Hold'em No Limit ($0.01/$0.02) - 2014/09/02 11:46:54 ET
Table 'Halley' 6-max Seat #1 is the button
Seat 1: samwest420 ($1.49 in chips) 
Seat 2: deoxy1909 ($1.04 in chips) 
Seat 3: masscap ($1.53 in chips) 
Seat 4: sepik200 ($1.90 in chips) 
Seat 5: Ruben.M1993 ($1.02 in chips) 
Seat 6: 04051979 ($1.88 in chips) 
deoxy1909: posts small blind $0.01
masscap: posts big blind $0.02
*** HOLE CARDS ***
Dealt to deoxy1909 [2d 5s]
sepik200: folds 
Ruben.M1993: folds 
04051979: raises $0.04 to $0.06
samwest420: calls $0.06
deoxy1909: folds 
masscap: folds 
*** FLOP *** [Th 7s Qc]
04051979: bets $0.11
samwest420: calls $0.11
*** TURN *** [Th 7s Qc] [Ac]
04051979: bets $0.26
samwest420: raises $0.26 to $0.52
04051979: folds 
Uncalled bet ($0.26) returned to samwest420
samwest420 collected $0.86 from pot
samwest420: doesn't show hand 
*** SUMMARY ***
Total pot $0.89 | Rake $0.03 
Board [Th 7s Qc Ac]
Seat 1: samwest420 (button) collected ($0.86)
Seat 2: deoxy1909 (small blind) folded before Flop
Seat 3: masscap (big blind) folded before Flop
Seat 4: sepik200 folded before Flop (didn't bet)
Seat 5: Ruben.M1993 folded before Flop (didn't bet)
Seat 6: 04051979 folded on the Turn



PokerStars Zoom Hand #120956877536:  Hold'em No Limit ($0.01/$0.02) - 2014/09/02 11:47:26 ET
Table 'Halley' 6-max Seat #1 is the button
Seat 1: deoxy1909 ($1.06 in chips) 
Seat 2: laiq428 ($1.94 in chips) 
Seat 3: artur21415 ($2 in chips) 
Seat 4: Csutora13 ($1.32 in chips) 
Seat 5: Thant0s ($2 in chips) 
Seat 6: werwer626 ($1.22 in chips) 
laiq428: posts small blind $0.01
artur21415: posts big blind $0.02
*** HOLE CARDS ***
Dealt to deoxy1909 [As Qh]
Csutora13: folds 
Thant0s: folds 
werwer626: raises $0.02 to $0.04
deoxy1909: raises $0.06 to $0.10
laiq428: calls $0.09
artur21415: folds 
werwer626: raises $0.10 to $0.20
deoxy1909: folds 
laiq428: calls $0.10
*** FLOP *** [Kc 9d 8d]
laiq428: checks 
werwer626: bets $1.02 and is all-in
laiq428: folds 
Uncalled bet ($1.02) returned to werwer626
werwer626 collected $0.50 from pot
werwer626: doesn't show hand 
*** SUMMARY ***
Total pot $0.52 | Rake $0.02 
Board [Kc 9d 8d]
Seat 1: deoxy1909 (button) folded before Flop
Seat 2: laiq428 (small blind) folded on the Flop
Seat 3: artur21415 (big blind) folded before Flop
Seat 4: Csutora13 folded before Flop (didn't bet)
Seat 5: Thant0s folded before Flop (didn't bet)
Seat 6: werwer626 collected ($0.50)



PokerStars Zoom Hand #120957023981:  Hold'em No Limit ($0.01/$0.02) - 2014/09/02 11:50:44 ET
Table 'Halley' 6-max Seat #1 is the button
Seat 1: ProffiY ($1.32 in chips) 
Seat 2: sir Grum ($2.01 in chips) 
Seat 3: deoxy1909 ($0.70 in chips) 
Seat 4: FigoBoss88 ($1.92 in chips) 
Seat 5: Aidar450 ($1.58 in chips) 
Seat 6: Zeoma ($1.97 in chips) 
sir Grum: posts small blind $0.01
deoxy1909: posts big blind $0.02
*** HOLE CARDS ***
Dealt to deoxy1909 [4d Kh]
FigoBoss88: folds 
Aidar450: folds 
Zeoma: folds 
ProffiY: calls $0.02
sir Grum: raises $0.06 to $0.08
deoxy1909: folds 
ProffiY: calls $0.06
*** FLOP *** [2h Td 9s]
sir Grum: bets $0.14
ProffiY: calls $0.14
*** TURN *** [2h Td 9s] [Kd]
sir Grum: bets $0.38
ProffiY: raises $0.38 to $0.76
sir Grum: calls $0.38
*** RIVER *** [2h Td 9s Kd] [As]
sir Grum: bets $0.95
ProffiY: calls $0.34 and is all-in
Uncalled bet ($0.61) returned to sir Grum
*** SHOW DOWN ***
sir Grum: shows [Ks Ah] (two pair, Aces and Kings)
ProffiY: shows [9h Tc] (two pair, Tens and Nines)
sir Grum collected $2.57 from pot
*** SUMMARY ***
Total pot $2.66 | Rake $0.09 
Board [2h Td 9s Kd As]
Seat 1: ProffiY (button) showed [9h Tc] and lost with two pair, Tens and Nines
Seat 2: sir Grum (small blind) showed [Ks Ah] and won ($2.57) with two pair, Aces and Kings
Seat 3: deoxy1909 (big blind) folded before Flop
Seat 4: FigoBoss88 folded before Flop (didn't bet)
Seat 5: Aidar450 folded before Flop (didn't bet)
Seat 6: Zeoma folded before Flop (didn't bet)



PokerStars Zoom Hand #120957079008:  Hold'em No Limit ($0.01/$0.02) - 2014/09/02 11:51:59 ET
Table 'Halley' 6-max Seat #1 is the button
Seat 1: Oksana1607 ($1.87 in chips) 
Seat 2: StanYankovic ($1.40 in chips) 
Seat 3: deoxy1909 ($0.66 in chips) 
Seat 4: arpie1 ($1.92 in chips) 
Seat 5: DjSinya ($4.80 in chips) 
Seat 6: Mamzicles ($2.03 in chips) 
StanYankovic: posts small blind $0.01
deoxy1909: posts big blind $0.02
*** HOLE CARDS ***
Dealt to deoxy1909 [Td 9c]
arpie1: calls $0.02
DjSinya: raises $0.06 to $0.08
Mamzicles: folds 
Oksana1607: calls $0.08
StanYankovic: folds 
deoxy1909: folds 
arpie1: calls $0.06
*** FLOP *** [Qc 9d Jc]
arpie1: checks 
DjSinya: bets $0.20
Oksana1607: calls $0.20
arpie1: calls $0.20
*** TURN *** [Qc 9d Jc] [Kd]
arpie1: checks 
DjSinya: checks 
Oksana1607: bets $0.02
arpie1: calls $0.02
DjSinya: calls $0.02
*** RIVER *** [Qc 9d Jc Kd] [Qh]
arpie1: checks 
DjSinya: checks 
Oksana1607: bets $0.10
arpie1: folds 
DjSinya: calls $0.10
*** SHOW DOWN ***
Oksana1607: shows [2h 2s] (two pair, Queens and Deuces)
DjSinya: shows [Ac Qd] (three of a kind, Queens)
DjSinya collected $1.09 from pot
*** SUMMARY ***
Total pot $1.13 | Rake $0.04 
Board [Qc 9d Jc Kd Qh]
Seat 1: Oksana1607 (button) showed [2h 2s] and lost with two pair, Queens and Deuces
Seat 2: StanYankovic (small blind) folded before Flop
Seat 3: deoxy1909 (big blind) folded before Flop
Seat 4: arpie1 folded on the River
Seat 5: DjSinya showed [Ac Qd] and won ($1.09) with three of a kind, Queens
Seat 6: Mamzicles folded before Flop (didn't bet)



PokerStars Zoom Hand #120957174894:  Hold'em No Limit ($0.01/$0.02) - 2014/09/02 11:54:08 ET
Table 'Halley' 6-max Seat #1 is the button
Seat 1: deoxy1909 ($0.71 in chips) 
Seat 2: kisshyde ($1.81 in chips) 
Seat 3: asp222380 ($2.42 in chips) 
Seat 4: d3nc ($3.06 in chips) 
Seat 5: dbyanchev ($2.01 in chips) 
Seat 6: jfhdye ($2.43 in chips) 
kisshyde: posts small blind $0.01
asp222380: posts big blind $0.02
*** HOLE CARDS ***
Dealt to deoxy1909 [6h 6s]
d3nc: folds 
dbyanchev: folds 
jfhdye: folds 
deoxy1909: raises $0.04 to $0.06
kisshyde: calls $0.05
asp222380: folds 
*** FLOP *** [Td Th Qh]
kisshyde: checks 
deoxy1909: bets $0.08
kisshyde: calls $0.08
*** TURN *** [Td Th Qh] [Ts]
kisshyde: checks 
deoxy1909: bets $0.20
kisshyde: calls $0.20
*** RIVER *** [Td Th Qh Ts] [4d]
kisshyde: checks 
deoxy1909: bets $0.37 and is all-in
kisshyde: calls $0.37
*** SHOW DOWN ***
deoxy1909: shows [6h 6s] (a full house, Tens full of Sixes)
kisshyde: shows [Qd As] (a full house, Tens full of Queens)
kisshyde collected $1.39 from pot
*** SUMMARY ***
Total pot $1.44 | Rake $0.05 
Board [Td Th Qh Ts 4d]
Seat 1: deoxy1909 (button) showed [6h 6s] and lost with a full house, Tens full of Sixes
Seat 2: kisshyde (small blind) showed [Qd As] and won ($1.39) with a full house, Tens full of Queens
Seat 3: asp222380 (big blind) folded before Flop
Seat 4: d3nc folded before Flop (didn't bet)
Seat 5: dbyanchev folded before Flop (didn't bet)
Seat 6: jfhdye folded before Flop (didn't bet)



PokerStars Zoom Hand #120957692192:  Hold'em No Limit ($0.01/$0.02) - 2014/09/02 12:06:37 ET
Table 'Halley' 6-max Seat #1 is the button
Seat 1: MishaMV1985 ($1.83 in chips) 
Seat 2: jovensitoAA ($2.05 in chips) 
Seat 3: deoxy1909 ($1.70 in chips) 
Seat 4: Fox0921 ($1.95 in chips) 
Seat 5: TaTaBossi ($1.30 in chips) 
Seat 6: xaris5555 ($2.01 in chips) 
jovensitoAA: posts small blind $0.01
deoxy1909: posts big blind $0.02
*** HOLE CARDS ***
Dealt to deoxy1909 [Qh Qd]
Fox0921: calls $0.02
TaTaBossi: folds 
xaris5555: folds 
MishaMV1985: raises $0.02 to $0.04
jovensitoAA: raises $2.01 to $2.05 and is all-in
deoxy1909: calls $1.68 and is all-in
Fox0921: folds 
MishaMV1985: folds 
Uncalled bet ($0.35) returned to jovensitoAA
*** FLOP *** [5s Qs 3h]
*** TURN *** [5s Qs 3h] [Kh]
*** RIVER *** [5s Qs 3h Kh] [Ad]
*** SHOW DOWN ***
jovensitoAA: shows [8s 7s] (high card Ace)
deoxy1909: shows [Qh Qd] (three of a kind, Queens)
deoxy1909 collected $3.34 from pot
*** SUMMARY ***
Total pot $3.46 | Rake $0.12 
Board [5s Qs 3h Kh Ad]
Seat 1: MishaMV1985 (button) folded before Flop
Seat 2: jovensitoAA (small blind) showed [8s 7s] and lost with high card Ace
Seat 3: deoxy1909 (big blind) showed [Qh Qd] and won ($3.34) with three of a kind, Queens
Seat 4: Fox0921 folded before Flop
Seat 5: TaTaBossi folded before Flop (didn't bet)
Seat 6: xaris5555 folded before Flop (didn't bet)



PokerStars Zoom Hand #120958232052:  Hold'em No Limit ($0.01/$0.02) - 2014/09/02 12:18:10 ET
Table 'Halley' 6-max Seat #1 is the button
Seat 1: deoxy1909 ($2.27 in chips) 
Seat 2: Fuchz ($2.57 in chips) 
Seat 3: dollarstarr ($3 in chips) 
Seat 4: Ukrop16 ($2.03 in chips) 
Seat 5: U_CTAC79 ($0.60 in chips) 
Seat 6: judersy ($1 in chips) 
Fuchz: posts small blind $0.01
dollarstarr: posts big blind $0.02
*** HOLE CARDS ***
Dealt to deoxy1909 [Ad Ah]
Ukrop16: folds 
U_CTAC79: calls $0.02
judersy: folds 
deoxy1909: raises $0.06 to $0.08
Fuchz: folds 
dollarstarr: folds 
U_CTAC79: calls $0.06
*** FLOP *** [Ks 3d 4c]
U_CTAC79: bets $0.11
deoxy1909: raises $0.11 to $0.22
U_CTAC79: calls $0.11
*** TURN *** [Ks 3d 4c] [4d]
U_CTAC79: checks 
deoxy1909: bets $0.44
U_CTAC79: calls $0.30 and is all-in
Uncalled bet ($0.14) returned to deoxy1909
*** FIRST RIVER *** [Ks 3d 4c 4d] [6d]
*** SECOND RIVER *** [Ks 3d 4c 4d] [Kh]
*** FIRST SHOW DOWN ***
U_CTAC79: shows [Th Kd] (two pair, Kings and Fours)
deoxy1909: shows [Ad Ah] (two pair, Aces and Fours)
deoxy1909 collected $0.60 from pot
*** SECOND SHOW DOWN ***
U_CTAC79: shows [Th Kd] (a full house, Kings full of Fours)
deoxy1909: shows [Ad Ah] (two pair, Aces and Kings)
U_CTAC79 collected $0.59 from pot
*** SUMMARY ***
Total pot $1.23 | Rake $0.04 
Hand was run twice
FIRST Board [Ks 3d 4c 4d 6d]
SECOND Board [Ks 3d 4c 4d Kh]
Seat 1: deoxy1909 (button) showed [Ad Ah] and won ($0.60) with two pair, Aces and Fours, and lost with two pair, Aces and Kings
Seat 2: Fuchz (small blind) folded before Flop
Seat 3: dollarstarr (big blind) folded before Flop
Seat 4: Ukrop16 folded before Flop (didn't bet)
Seat 5: U_CTAC79 showed [Th Kd] and lost with two pair, Kings and Fours, and won ($0.59) with a full house, Kings full of Fours
Seat 6: judersy folded before Flop (didn't bet)



PokerStars Zoom Hand #120958447542:  Hold'em No Limit ($0.01/$0.02) - 2014/09/02 12:22:45 ET
Table 'Halley' 6-max Seat #1 is the button
Seat 1: F0ody ($2.14 in chips) 
Seat 2: deoxy1909 ($2.19 in chips) 
Seat 3: Dark Aqua ($2.11 in chips) 
Seat 4: Walrus91 ($2.45 in chips) 
Seat 5: 1PROSPERUS8 ($2.83 in chips) 
Seat 6: marcioohara ($1.91 in chips) 
deoxy1909: posts small blind $0.01
Dark Aqua: posts big blind $0.02
*** HOLE CARDS ***
Dealt to deoxy1909 [Th 2h]
Walrus91: folds 
1PROSPERUS8: folds 
marcioohara: calls $0.02
F0ody: folds 
deoxy1909: folds 
Dark Aqua: checks 
*** FLOP *** [Jc 3h Qs]
Dark Aqua: bets $0.05
marcioohara: calls $0.05
*** TURN *** [Jc 3h Qs] [Kh]
Dark Aqua: bets $0.10
marcioohara: calls $0.10
*** RIVER *** [Jc 3h Qs Kh] [Jh]
Dark Aqua: bets $0.25
marcioohara: calls $0.25
*** SHOW DOWN ***
Dark Aqua: shows [Qc Js] (a full house, Jacks full of Queens)
marcioohara: mucks hand 
Dark Aqua collected $0.82 from pot
*** SUMMARY ***
Total pot $0.85 | Rake $0.03 
Board [Jc 3h Qs Kh Jh]
Seat 1: F0ody (button) folded before Flop (didn't bet)
Seat 2: deoxy1909 (small blind) folded before Flop
Seat 3: Dark Aqua (big blind) showed [Qc Js] and won ($0.82) with a full house, Jacks full of Queens
Seat 4: Walrus91 folded before Flop (didn't bet)
Seat 5: 1PROSPERUS8 folded before Flop (didn't bet)
Seat 6: marcioohara mucked [Jd Ah]



PokerStars Zoom Hand #120958666217:  Hold'em No Limit ($0.01/$0.02) - 2014/09/02 12:27:22 ET
Table 'Halley' 6-max Seat #1 is the button
Seat 1: deoxy1909 ($1.88 in chips) 
Seat 2: LazySmuggler ($2.09 in chips) 
Seat 3: issue_lv ($3.79 in chips) 
Seat 4: Scifox ($2.28 in chips) 
Seat 5: oleg310774 ($3.47 in chips) 
Seat 6: raikov86 ($2.33 in chips) 
LazySmuggler: posts small blind $0.01
issue_lv: posts big blind $0.02
*** HOLE CARDS ***
Dealt to deoxy1909 [6s 5d]
Scifox: folds 
oleg310774: raises $0.02 to $0.04
raikov86: calls $0.04
deoxy1909: folds 
LazySmuggler: folds 
issue_lv: folds 
*** FLOP *** [6c 5s 2s]
oleg310774: bets $0.05
raikov86: calls $0.05
*** TURN *** [6c 5s 2s] [7d]
oleg310774: bets $0.10
raikov86: calls $0.10
*** RIVER *** [6c 5s 2s 7d] [Jc]
oleg310774: bets $0.20
raikov86: calls $0.20
*** SHOW DOWN ***
oleg310774: shows [Ks Th] (high card King)
raikov86: shows [6d As] (a pair of Sixes)
raikov86 collected $0.78 from pot
*** SUMMARY ***
Total pot $0.81 | Rake $0.03 
Board [6c 5s 2s 7d Jc]
Seat 1: deoxy1909 (button) folded before Flop (didn't bet)
Seat 2: LazySmuggler (small blind) folded before Flop
Seat 3: issue_lv (big blind) folded before Flop
Seat 4: Scifox folded before Flop (didn't bet)
Seat 5: oleg310774 showed [Ks Th] and lost with high card King
Seat 6: raikov86 showed [6d As] and won ($0.78) with a pair of Sixes



PokerStars Zoom Hand #120959134607:  Hold'em No Limit ($0.01/$0.02) - 2014/09/02 12:37:04 ET
Table 'Halley' 6-max Seat #1 is the button
Seat 1: vetal972 ($2.52 in chips) 
Seat 2: deoxy1909 ($1.70 in chips) 
Seat 3: luneism ($2.04 in chips) 
Seat 4: MixaNiko ($2.27 in chips) 
Seat 5: xavante_7 ($8.23 in chips) 
Seat 6: HenrYtheK ($3.23 in chips) 
deoxy1909: posts small blind $0.01
luneism: posts big blind $0.02
*** HOLE CARDS ***
Dealt to deoxy1909 [2c 6c]
MixaNiko: folds 
xavante_7: raises $0.05 to $0.07
HenrYtheK: calls $0.07
vetal972: folds 
deoxy1909: folds 
luneism: raises $0.19 to $0.26
xavante_7: calls $0.19
HenrYtheK: folds 
*** FLOP *** [6s 3s 7h]
luneism: bets $0.32
xavante_7: raises $7.65 to $7.97 and is all-in
luneism: calls $1.46 and is all-in
Uncalled bet ($6.19) returned to xavante_7
*** TURN *** [6s 3s 7h] [Ah]
*** RIVER *** [6s 3s 7h Ah] [Kh]
*** SHOW DOWN ***
luneism: shows [Qs Qd] (a pair of Queens)
xavante_7: shows [As Qh] (a pair of Aces)
xavante_7 collected $4.01 from pot
*** SUMMARY ***
Total pot $4.16 | Rake $0.15 
Board [6s 3s 7h Ah Kh]
Seat 1: vetal972 (button) folded before Flop (didn't bet)
Seat 2: deoxy1909 (small blind) folded before Flop
Seat 3: luneism (big blind) showed [Qs Qd] and lost with a pair of Queens
Seat 4: MixaNiko folded before Flop (didn't bet)
Seat 5: xavante_7 showed [As Qh] and won ($4.01) with a pair of Aces
Seat 6: HenrYtheK folded before Flop



PokerStars Zoom Hand #120959269086:  Hold'em No Limit ($0.01/$0.02) - 2014/09/02 12:39:49 ET
Table 'Halley' 6-max Seat #1 is the button
Seat 1: ÅÅÅÅÅÅÅÅ ($2.86 in chips) 
Seat 2: pokoslav2010 ($2.14 in chips) 
Seat 3: 19shpan86 ($1.77 in chips) 
Seat 4: deoxy1909 ($1.54 in chips) 
Seat 5: POSHERO ($1.93 in chips) 
Seat 6: Lica973 ($2.29 in chips) 
pokoslav2010: posts small blind $0.01
19shpan86: posts big blind $0.02
*** HOLE CARDS ***
Dealt to deoxy1909 [Ac 9s]
deoxy1909: raises $0.04 to $0.06
POSHERO: calls $0.06
Lica973: folds 
ÅÅÅÅÅÅÅÅ: calls $0.06
pokoslav2010: folds 
19shpan86: calls $0.04
*** FLOP *** [2c 3c 4s]
19shpan86: bets $0.04
deoxy1909: calls $0.04
POSHERO: folds 
ÅÅÅÅÅÅÅÅ: raises $0.14 to $0.18
19shpan86: calls $0.14
deoxy1909: calls $0.14
*** TURN *** [2c 3c 4s] [Th]
19shpan86: checks 
deoxy1909: checks 
ÅÅÅÅÅÅÅÅ: bets $0.59
19shpan86: folds 
deoxy1909: folds 
Uncalled bet ($0.59) returned to ÅÅÅÅÅÅÅÅ
ÅÅÅÅÅÅÅÅ collected $0.76 from pot
ÅÅÅÅÅÅÅÅ: doesn't show hand 
*** SUMMARY ***
Total pot $0.79 | Rake $0.03 
Board [2c 3c 4s Th]
Seat 1: ÅÅÅÅÅÅÅÅ (button) collected ($0.76)
Seat 2: pokoslav2010 (small blind) folded before Flop
Seat 3: 19shpan86 (big blind) folded on the Turn
Seat 4: deoxy1909 folded on the Turn
Seat 5: POSHERO folded on the Flop
Seat 6: Lica973 folded before Flop (didn't bet)



PokerStars Zoom Hand #120959363305:  Hold'em No Limit ($0.01/$0.02) - 2014/09/02 12:41:45 ET
Table 'Halley' 6-max Seat #1 is the button
Seat 1: polydur ($2.16 in chips) 
Seat 2: deoxy1909 ($1.33 in chips) 
Seat 3: RubberTruck ($0.55 in chips) 
Seat 4: Anastassiya3 ($4.23 in chips) 
Seat 5: Kaliban12 ($3.70 in chips) 
Seat 6: zukinjo ($1.73 in chips) 
deoxy1909: posts small blind $0.01
RubberTruck: posts big blind $0.02
*** HOLE CARDS ***
Dealt to deoxy1909 [Ac 9h]
Anastassiya3: folds 
Kaliban12: folds 
zukinjo: raises $0.04 to $0.06
polydur: folds 
deoxy1909: calls $0.05
RubberTruck: calls $0.04
*** FLOP *** [2h 9d 2s]
deoxy1909: bets $0.12
RubberTruck: calls $0.12
zukinjo: calls $0.12
*** TURN *** [2h 9d 2s] [6s]
deoxy1909: bets $0.38
RubberTruck: calls $0.37 and is all-in
zukinjo: folds 
Uncalled bet ($0.01) returned to deoxy1909
*** RIVER *** [2h 9d 2s 6s] [Jc]
*** SHOW DOWN ***
deoxy1909: shows [Ac 9h] (two pair, Nines and Deuces)
RubberTruck: shows [3d 2d] (three of a kind, Deuces)
RubberTruck collected $1.24 from pot
*** SUMMARY ***
Total pot $1.28 | Rake $0.04 
Board [2h 9d 2s 6s Jc]
Seat 1: polydur (button) folded before Flop (didn't bet)
Seat 2: deoxy1909 (small blind) showed [Ac 9h] and lost with two pair, Nines and Deuces
Seat 3: RubberTruck (big blind) showed [3d 2d] and won ($1.24) with three of a kind, Deuces
Seat 4: Anastassiya3 folded before Flop (didn't bet)
Seat 5: Kaliban12 folded before Flop (didn't bet)
Seat 6: zukinjo folded on the Turn



PokerStars Zoom Hand #120959671909:  Hold'em No Limit ($0.01/$0.02) - 2014/09/02 12:48:03 ET
Table 'Halley' 6-max Seat #1 is the button
Seat 1: Evuil ($2 in chips) 
Seat 2: deoxy1909 ($0.82 in chips) 
Seat 3: puncik cz ($1 in chips) 
Seat 4: U_CTAC79 ($1.26 in chips) 
Seat 5: sZRAMEK ($4.98 in chips) 
Seat 6: fakill_1 ($1.70 in chips) 
deoxy1909: posts small blind $0.01
puncik cz: posts big blind $0.02
*** HOLE CARDS ***
Dealt to deoxy1909 [2d Qc]
U_CTAC79: calls $0.02
sZRAMEK: folds 
fakill_1: raises $0.04 to $0.06
Evuil: folds 
deoxy1909: folds 
puncik cz: calls $0.04
U_CTAC79: calls $0.04
*** FLOP *** [2h 3c 6d]
puncik cz: checks 
U_CTAC79: checks 
fakill_1: bets $0.09
puncik cz: calls $0.09
U_CTAC79: folds 
*** TURN *** [2h 3c 6d] [8c]
puncik cz: checks 
fakill_1: bets $0.18
puncik cz: calls $0.18
*** RIVER *** [2h 3c 6d 8c] [9h]
puncik cz: checks 
fakill_1: checks 
*** SHOW DOWN ***
puncik cz: shows [Js Ad] (high card Ace)
fakill_1: shows [Ah Kh] (high card Ace - King kicker)
fakill_1 collected $0.70 from pot
*** SUMMARY ***
Total pot $0.73 | Rake $0.03 
Board [2h 3c 6d 8c 9h]
Seat 1: Evuil (button) folded before Flop (didn't bet)
Seat 2: deoxy1909 (small blind) folded before Flop
Seat 3: puncik cz (big blind) showed [Js Ad] and lost with high card Ace
Seat 4: U_CTAC79 folded on the Flop
Seat 5: sZRAMEK folded before Flop (didn't bet)
Seat 6: fakill_1 showed [Ah Kh] and won ($0.70) with high card Ace



PokerStars Zoom Hand #120959719423:  Hold'em No Limit ($0.01/$0.02) - 2014/09/02 12:49:01 ET
Table 'Halley' 6-max Seat #1 is the button
Seat 1: bullof ($5.75 in chips) 
Seat 2: snucer2010 ($1.55 in chips) 
Seat 3: issue_lv ($5.04 in chips) 
Seat 4: rndroman ($1 in chips) 
Seat 5: EzLifeStyle ($1.43 in chips) 
Seat 6: deoxy1909 ($0.81 in chips) 
snucer2010: posts small blind $0.01
issue_lv: posts big blind $0.02
*** HOLE CARDS ***
Dealt to deoxy1909 [Qh Qd]
rndroman: folds 
EzLifeStyle: folds 
deoxy1909: raises $0.04 to $0.06
bullof: calls $0.06
snucer2010: folds 
issue_lv: folds 
*** FLOP *** [3h 9c 4c]
deoxy1909: bets $0.10
bullof: raises $0.34 to $0.44
deoxy1909: calls $0.34
*** TURN *** [3h 9c 4c] [5d]
deoxy1909: bets $0.31 and is all-in
bullof: calls $0.31
*** RIVER *** [3h 9c 4c 5d] [7c]
*** SHOW DOWN ***
deoxy1909: shows [Qh Qd] (a pair of Queens)
bullof: shows [Td Th] (a pair of Tens)
deoxy1909 collected $1.59 from pot
*** SUMMARY ***
Total pot $1.65 | Rake $0.06 
Board [3h 9c 4c 5d 7c]
Seat 1: bullof (button) showed [Td Th] and lost with a pair of Tens
Seat 2: snucer2010 (small blind) folded before Flop
Seat 3: issue_lv (big blind) folded before Flop
Seat 4: rndroman folded before Flop (didn't bet)
Seat 5: EzLifeStyle folded before Flop (didn't bet)
Seat 6: deoxy1909 showed [Qh Qd] and won ($1.59) with a pair of Queens



PokerStars Zoom Hand #120960085679:  Hold'em No Limit ($0.01/$0.02) - 2014/09/02 12:56:56 ET
Table 'Halley' 6-max Seat #1 is the button
Seat 1: Gaylerd ($2.16 in chips) 
Seat 2: deoxy1909 ($1.70 in chips) 
Seat 3: gudfree ($2.14 in chips) 
Seat 4: ira2512 ($2.01 in chips) 
Seat 5: humblegamer ($2.20 in chips) 
Seat 6: DeaTHmazDAI ($2.17 in chips) 
deoxy1909: posts small blind $0.01
gudfree: posts big blind $0.02
*** HOLE CARDS ***
Dealt to deoxy1909 [2d 3d]
ira2512: calls $0.02
humblegamer: calls $0.02
DeaTHmazDAI: folds 
Gaylerd: raises $0.18 to $0.20
deoxy1909: folds 
gudfree: folds 
ira2512: folds 
humblegamer: raises $0.46 to $0.66
Gaylerd: raises $1.37 to $2.03
humblegamer: folds 
Uncalled bet ($1.37) returned to Gaylerd
Gaylerd collected $1.37 from pot
Gaylerd: doesn't show hand 
*** SUMMARY ***
Total pot $1.37 | Rake $0 
Seat 1: Gaylerd (button) collected ($1.37)
Seat 2: deoxy1909 (small blind) folded before Flop
Seat 3: gudfree (big blind) folded before Flop
Seat 4: ira2512 folded before Flop
Seat 5: humblegamer folded before Flop
Seat 6: DeaTHmazDAI folded before Flop (didn't bet)



PokerStars Zoom Hand #120960310567:  Hold'em No Limit ($0.01/$0.02) - 2014/09/02 13:02:25 ET
Table 'Halley' 6-max Seat #1 is the button
Seat 1: deoxy1909 ($1.75 in chips) 
Seat 2: xavante_7 ($0.61 in chips) 
Seat 3: dollarstarr ($2.79 in chips) 
Seat 4: Mikhail Kat ($1.18 in chips) 
Seat 5: gonndoR ($2.19 in chips) 
Seat 6: TeipWorm ($2.68 in chips) 
xavante_7: posts small blind $0.01
dollarstarr: posts big blind $0.02
*** HOLE CARDS ***
Dealt to deoxy1909 [9d Kh]
Mikhail Kat: raises $0.02 to $0.04
gonndoR: calls $0.04
TeipWorm: calls $0.04
deoxy1909: folds 
xavante_7: folds 
dollarstarr: folds 
*** FLOP *** [7s Qs 5h]
Mikhail Kat: bets $0.07
gonndoR: calls $0.07
TeipWorm: raises $0.26 to $0.33
Mikhail Kat: calls $0.26
gonndoR: folds 
*** TURN *** [7s Qs 5h] [8c]
Mikhail Kat: checks 
TeipWorm: bets $0.85
Mikhail Kat: calls $0.81 and is all-in
Uncalled bet ($0.04) returned to TeipWorm
*** RIVER *** [7s Qs 5h 8c] [9h]
*** SHOW DOWN ***
Mikhail Kat: shows [Qh Ah] (a pair of Queens)
TeipWorm: mucks hand 
Mikhail Kat collected $2.41 from pot
*** SUMMARY ***
Total pot $2.50 | Rake $0.09 
Board [7s Qs 5h 8c 9h]
Seat 1: deoxy1909 (button) folded before Flop (didn't bet)
Seat 2: xavante_7 (small blind) folded before Flop
Seat 3: dollarstarr (big blind) folded before Flop
Seat 4: Mikhail Kat showed [Qh Ah] and won ($2.41) with a pair of Queens
Seat 5: gonndoR folded on the Flop
Seat 6: TeipWorm mucked [Qd Jd]



PokerStars Zoom Hand #120960350426:  Hold'em No Limit ($0.01/$0.02) - 2014/09/02 13:03:13 ET
Table 'Halley' 6-max Seat #1 is the button
Seat 1: chemluth ($3.77 in chips) 
Seat 2: Missrmc ($3.15 in chips) 
Seat 3: deoxy1909 ($1.72 in chips) 
Seat 4: DamagePro ($3.40 in chips) 
Seat 5: Allexii ($1.11 in chips) 
Seat 6: pierrehhh ($1.02 in chips) 
Missrmc: posts small blind $0.01
deoxy1909: posts big blind $0.02
*** HOLE CARDS ***
Dealt to deoxy1909 [5c 7s]
DamagePro: raises $0.04 to $0.06
Allexii: folds 
pierrehhh: calls $0.06
chemluth: folds 
Missrmc: raises $0.04 to $0.10
deoxy1909: folds 
DamagePro: calls $0.04
pierrehhh: calls $0.04
*** FLOP *** [Qd 3d Jc]
Missrmc: bets $0.31
DamagePro: calls $0.31
pierrehhh: folds 
*** TURN *** [Qd 3d Jc] [3h]
Missrmc: bets $0.91
DamagePro: folds 
Uncalled bet ($0.91) returned to Missrmc
Missrmc collected $0.91 from pot
Missrmc: doesn't show hand 
*** SUMMARY ***
Total pot $0.94 | Rake $0.03 
Board [Qd 3d Jc 3h]
Seat 1: chemluth (button) folded before Flop (didn't bet)
Seat 2: Missrmc (small blind) collected ($0.91)
Seat 3: deoxy1909 (big blind) folded before Flop
Seat 4: DamagePro folded on the Turn
Seat 5: Allexii folded before Flop (didn't bet)
Seat 6: pierrehhh folded on the Flop



PokerStars Zoom Hand #120960475567:  Hold'em No Limit ($0.01/$0.02) - 2014/09/02 13:05:42 ET
Table 'Halley' 6-max Seat #1 is the button
Seat 1: deoxy1909 ($1.73 in chips) 
Seat 2: THRaven23 ($0.65 in chips) 
Seat 3: Testspiel ($3.87 in chips) 
Seat 4: sotiris82 ($2.13 in chips) 
Seat 5: valerossipma ($2.03 in chips) 
Seat 6: koksEX ($1.84 in chips) 
THRaven23: posts small blind $0.01
Testspiel: posts big blind $0.02
*** HOLE CARDS ***
Dealt to deoxy1909 [9h 9d]
sotiris82: raises $0.04 to $0.06
valerossipma: folds 
koksEX: folds 
deoxy1909: calls $0.06
THRaven23: calls $0.05
Testspiel: folds 
*** FLOP *** [6s 2d 5s]
THRaven23: checks 
sotiris82: checks 
deoxy1909: bets $0.12
THRaven23: folds 
sotiris82: calls $0.12
*** TURN *** [6s 2d 5s] [As]
sotiris82: checks 
deoxy1909: bets $0.30
sotiris82: raises $1.65 to $1.95 and is all-in
deoxy1909: folds 
Uncalled bet ($1.65) returned to sotiris82
sotiris82 collected $1 from pot
sotiris82: doesn't show hand 
*** SUMMARY ***
Total pot $1.04 | Rake $0.04 
Board [6s 2d 5s As]
Seat 1: deoxy1909 (button) folded on the Turn
Seat 2: THRaven23 (small blind) folded on the Flop
Seat 3: Testspiel (big blind) folded before Flop
Seat 4: sotiris82 collected ($1)
Seat 5: valerossipma folded before Flop (didn't bet)
Seat 6: koksEX folded before Flop (didn't bet)



PokerStars Zoom Hand #120960600713:  Hold'em No Limit ($0.01/$0.02) - 2014/09/02 13:08:11 ET
Table 'Halley' 6-max Seat #1 is the button
Seat 1: Fyzzler ($2 in chips) 
Seat 2: Ridzik30 ($2.28 in chips) 
Seat 3: Rimma787 ($2.20 in chips) 
Seat 4: sesilmario ($1.20 in chips) 
Seat 5: deoxy1909 ($1.37 in chips) 
Seat 6: PGorbachev ($0.64 in chips) 
Ridzik30: posts small blind $0.01
Rimma787: posts big blind $0.02
*** HOLE CARDS ***
Dealt to deoxy1909 [Ac Qs]
sesilmario: calls $0.02
deoxy1909: raises $0.06 to $0.08
PGorbachev: folds 
Fyzzler: folds 
Ridzik30: folds 
Rimma787: calls $0.06
sesilmario: calls $0.06
*** FLOP *** [Td As Jc]
Rimma787: checks 
sesilmario: checks 
deoxy1909: bets $0.16
Rimma787: calls $0.16
sesilmario: calls $0.16
*** TURN *** [Td As Jc] [Jh]
Rimma787: checks 
sesilmario: checks 
deoxy1909: bets $0.52
Rimma787: calls $0.52
sesilmario: calls $0.52
*** RIVER *** [Td As Jc Jh] [5d]
Rimma787: checks 
sesilmario: checks 
deoxy1909: bets $0.61 and is all-in
Rimma787: calls $0.61
sesilmario: folds 
*** SHOW DOWN ***
deoxy1909: shows [Ac Qs] (two pair, Aces and Jacks)
Rimma787: shows [Qh Ah] (two pair, Aces and Jacks)
Rimma787 collected $1.70 from pot
deoxy1909 collected $1.69 from pot
*** SUMMARY ***
Total pot $3.51 | Rake $0.12 
Board [Td As Jc Jh 5d]
Seat 1: Fyzzler (button) folded before Flop (didn't bet)
Seat 2: Ridzik30 (small blind) folded before Flop
Seat 3: Rimma787 (big blind) showed [Qh Ah] and won ($1.70) with two pair, Aces and Jacks
Seat 4: sesilmario folded on the River
Seat 5: deoxy1909 showed [Ac Qs] and won ($1.69) with two pair, Aces and Jacks
Seat 6: PGorbachev folded before Flop (didn't bet)



PokerStars Zoom Hand #120960851766:  Hold'em No Limit ($0.01/$0.02) - 2014/09/02 13:13:14 ET
Table 'Halley' 6-max Seat #1 is the button
Seat 1: Wozieee ($3.80 in chips) 
Seat 2: sanja2007789 ($3.96 in chips) 
Seat 3: deoxy1909 ($1.62 in chips) 
Seat 4: Rybin sergey ($3.37 in chips) 
Seat 5: DistWork ($2.42 in chips) 
Seat 6: sakippo ($2 in chips) 
sanja2007789: posts small blind $0.01
deoxy1909: posts big blind $0.02
*** HOLE CARDS ***
Dealt to deoxy1909 [7s As]
Rybin sergey: folds 
DistWork: folds 
sakippo: folds 
Wozieee: raises $0.20 to $0.22
sanja2007789: calls $0.21
deoxy1909: folds 
*** FLOP *** [7h 3h 4s]
sanja2007789: checks 
Wozieee: bets $0.22
sanja2007789: calls $0.22
*** TURN *** [7h 3h 4s] [8c]
sanja2007789: checks 
Wozieee: checks 
*** RIVER *** [7h 3h 4s 8c] [5d]
sanja2007789: bets $0.87
Wozieee: folds 
Uncalled bet ($0.87) returned to sanja2007789
sanja2007789 collected $0.87 from pot
sanja2007789: doesn't show hand 
*** SUMMARY ***
Total pot $0.90 | Rake $0.03 
Board [7h 3h 4s 8c 5d]
Seat 1: Wozieee (button) folded on the River
Seat 2: sanja2007789 (small blind) collected ($0.87)
Seat 3: deoxy1909 (big blind) folded before Flop
Seat 4: Rybin sergey folded before Flop (didn't bet)
Seat 5: DistWork folded before Flop (didn't bet)
Seat 6: sakippo folded before Flop (didn't bet)



PokerStars Zoom Hand #120960873885:  Hold'em No Limit ($0.01/$0.02) - 2014/09/02 13:13:40 ET
Table 'Halley' 6-max Seat #1 is the button
Seat 1: Tn 939 ($2.08 in chips) 
Seat 2: deoxy1909 ($1.60 in chips) 
Seat 3: longhair180 ($2 in chips) 
Seat 4: Za7aLaMeL ($1 in chips) 
Seat 5: bandziorno81 ($2 in chips) 
Seat 6: rnfh ($2.50 in chips) 
deoxy1909: posts small blind $0.01
longhair180: posts big blind $0.02
*** HOLE CARDS ***
Dealt to deoxy1909 [9c 9s]
Za7aLaMeL: folds 
bandziorno81: folds 
rnfh: folds 
Tn 939: raises $0.03 to $0.05
deoxy1909: calls $0.04
longhair180: calls $0.03
*** FLOP *** [5d 7c 4h]
deoxy1909: bets $0.10
longhair180: raises $0.10 to $0.20
Tn 939: folds 
deoxy1909: calls $0.10
*** TURN *** [5d 7c 4h] [2d]
deoxy1909: bets $0.40
longhair180: raises $0.40 to $0.80
deoxy1909: calls $0.40
*** RIVER *** [5d 7c 4h 2d] [2s]
deoxy1909: checks 
longhair180: checks 
*** SHOW DOWN ***
deoxy1909: shows [9c 9s] (two pair, Nines and Deuces)
longhair180: mucks hand 
deoxy1909 collected $2.07 from pot
*** SUMMARY ***
Total pot $2.15 | Rake $0.08 
Board [5d 7c 4h 2d 2s]
Seat 1: Tn 939 (button) folded on the Flop
Seat 2: deoxy1909 (small blind) showed [9c 9s] and won ($2.07) with two pair, Nines and Deuces
Seat 3: longhair180 (big blind) mucked [6d 7d]
Seat 4: Za7aLaMeL folded before Flop (didn't bet)
Seat 5: bandziorno81 folded before Flop (didn't bet)
Seat 6: rnfh folded before Flop (didn't bet)



PokerStars Zoom Hand #120960907878:  Hold'em No Limit ($0.01/$0.02) - 2014/09/02 13:14:21 ET
Table 'Halley' 6-max Seat #1 is the button
Seat 1: semarg1 ($2 in chips) 
Seat 2: O.S.W.L.L. ($2.07 in chips) 
Seat 3: deoxy1909 ($2.62 in chips) 
Seat 4: Kostya Red ($5.19 in chips) 
Seat 5: marta328 ($2.02 in chips) 
Seat 6: OLLEG277 ($8.56 in chips) 
O.S.W.L.L.: posts small blind $0.01
deoxy1909: posts big blind $0.02
*** HOLE CARDS ***
Dealt to deoxy1909 [Qd Qh]
Kostya Red: raises $0.03 to $0.05
marta328: folds 
OLLEG277: folds 
semarg1: raises $0.07 to $0.12
O.S.W.L.L.: folds 
deoxy1909: raises $0.24 to $0.36
Kostya Red: folds 
semarg1: raises $0.24 to $0.60
deoxy1909: raises $2.02 to $2.62 and is all-in
semarg1: calls $1.40 and is all-in
Uncalled bet ($0.62) returned to deoxy1909
*** FIRST FLOP *** [Jd Ah 9s]
*** FIRST TURN *** [Jd Ah 9s] [3s]
*** FIRST RIVER *** [Jd Ah 9s 3s] [Ac]
*** SECOND FLOP *** [8d Jh Ts]
*** SECOND TURN *** [8d Jh Ts] [7d]
*** SECOND RIVER *** [8d Jh Ts 7d] [7c]
*** FIRST SHOW DOWN ***
deoxy1909: shows [Qd Qh] (two pair, Aces and Queens)
semarg1: shows [Kc Kd] (two pair, Aces and Kings)
semarg1 collected $1.96 from pot
*** SECOND SHOW DOWN ***
deoxy1909: shows [Qd Qh] (two pair, Queens and Sevens)
semarg1: shows [Kc Kd] (two pair, Kings and Sevens)
semarg1 collected $1.96 from pot
*** SUMMARY ***
Total pot $4.06 | Rake $0.14 
Hand was run twice
FIRST Board [Jd Ah 9s 3s Ac]
SECOND Board [8d Jh Ts 7d 7c]
Seat 1: semarg1 (button) showed [Kc Kd] and won ($1.96) with two pair, Aces and Kings, and won ($1.96) with two pair, Kings and Sevens
Seat 2: O.S.W.L.L. (small blind) folded before Flop
Seat 3: deoxy1909 (big blind) showed [Qd Qh] and lost with two pair, Aces and Queens, and lost with two pair, Queens and Sevens
Seat 4: Kostya Red folded before Flop
Seat 5: marta328 folded before Flop (didn't bet)
Seat 6: OLLEG277 folded before Flop (didn't bet)



PokerStars Zoom Hand #120950732726:  Hold'em No Limit ($0.01/$0.02) - 2014/09/02 9:15:59 ET
Table 'Halley' 6-max Seat #1 is the button
Seat 1: deoxy1909 ($1.99 in chips) 
Seat 2: Oxi4OK1 ($2.57 in chips) 
Seat 3: zazexp ($2.05 in chips) 
Seat 4: JaramSobie ($2.65 in chips) 
Seat 5: Érko ($2.01 in chips) 
Seat 6: acerip8 ($2.02 in chips) 
Oxi4OK1: posts small blind $0.01
zazexp: posts big blind $0.02
*** HOLE CARDS ***
Dealt to deoxy1909 [Kc Qh]
JaramSobie: raises $0.04 to $0.06
Érko: folds 
acerip8: calls $0.06
deoxy1909: raises $0.04 to $0.10
Oxi4OK1: folds 
zazexp: folds 
JaramSobie: calls $0.04
acerip8: calls $0.04
*** FLOP *** [4c 3h Kh]
JaramSobie: checks 
acerip8: checks 
deoxy1909: bets $0.22
JaramSobie: calls $0.22
acerip8: folds 
*** TURN *** [4c 3h Kh] [Jc]
JaramSobie: checks 
deoxy1909: bets $0.56
JaramSobie: raises $0.56 to $1.12
deoxy1909: raises $0.55 to $1.67 and is all-in
JaramSobie: calls $0.55
*** RIVER *** [4c 3h Kh Jc] [5s]
*** SHOW DOWN ***
JaramSobie: shows [3d 3s] (three of a kind, Threes)
deoxy1909: shows [Kc Qh] (a pair of Kings)
JaramSobie collected $3.97 from pot
*** SUMMARY ***
Total pot $4.11 | Rake $0.14 
Board [4c 3h Kh Jc 5s]
Seat 1: deoxy1909 (button) showed [Kc Qh] and lost with a pair of Kings
Seat 2: Oxi4OK1 (small blind) folded before Flop
Seat 3: zazexp (big blind) folded before Flop
Seat 4: JaramSobie showed [3d 3s] and won ($3.97) with three of a kind, Threes
Seat 5: Érko folded before Flop (didn't bet)
Seat 6: acerip8 folded on the Flop



PokerStars Zoom Hand #120950849960:  Hold'em No Limit ($0.01/$0.02) - 2014/09/02 9:19:06 ET
Table 'Halley' 6-max Seat #1 is the button
Seat 1: deoxy1909 ($1.94 in chips) 
Seat 2: OZ 33799 ($4.04 in chips) 
Seat 3: Marcepan77 ($2.68 in chips) 
Seat 4: shapely89 ($2.93 in chips) 
Seat 5: natimati05 ($1.91 in chips) 
Seat 6: KYR333 ($3.57 in chips) 
OZ 33799: posts small blind $0.01
Marcepan77: posts big blind $0.02
*** HOLE CARDS ***
Dealt to deoxy1909 [6h 3h]
shapely89: raises $0.06 to $0.08
natimati05: folds 
KYR333: calls $0.08
deoxy1909: folds 
OZ 33799: calls $0.07
Marcepan77: folds 
*** FLOP *** [8h 7c 2d]
OZ 33799: checks 
shapely89: bets $0.16
KYR333: folds 
OZ 33799: calls $0.16
*** TURN *** [8h 7c 2d] [9d]
OZ 33799: checks 
shapely89: checks 
*** RIVER *** [8h 7c 2d 9d] [4s]
OZ 33799: checks 
shapely89: checks 
*** SHOW DOWN ***
OZ 33799: shows [Ad Th] (high card Ace)
shapely89: mucks hand 
OZ 33799 collected $0.56 from pot
*** SUMMARY ***
Total pot $0.58 | Rake $0.02 
Board [8h 7c 2d 9d 4s]
Seat 1: deoxy1909 (button) folded before Flop (didn't bet)
Seat 2: OZ 33799 (small blind) showed [Ad Th] and won ($0.56) with high card Ace
Seat 3: Marcepan77 (big blind) folded before Flop
Seat 4: shapely89 mucked [Kh Qs]
Seat 5: natimati05 folded before Flop (didn't bet)
Seat 6: KYR333 folded on the Flop



PokerStars Zoom Hand #120950930497:  Hold'em No Limit ($0.01/$0.02) - 2014/09/02 9:21:15 ET
Table 'Halley' 6-max Seat #1 is the button
Seat 1: gosha-zt ($3.22 in chips) 
Seat 2: Masterc66 ($2.03 in chips) 
Seat 3: deoxy1909 ($2.02 in chips) 
Seat 4: OSA_Rodeo ($12.95 in chips) 
Seat 5: martoo1003 ($2.11 in chips) 
Seat 6: darecripple ($2.15 in chips) 
Masterc66: posts small blind $0.01
deoxy1909: posts big blind $0.02
*** HOLE CARDS ***
Dealt to deoxy1909 [6d Kc]
OSA_Rodeo: raises $0.03 to $0.05
martoo1003: folds 
darecripple: folds 
gosha-zt: raises $0.05 to $0.10
Masterc66: folds 
deoxy1909: folds 
OSA_Rodeo: calls $0.05
*** FLOP *** [Js 4h Kh]
OSA_Rodeo: checks 
gosha-zt: bets $0.10
OSA_Rodeo: calls $0.10
*** TURN *** [Js 4h Kh] [Th]
OSA_Rodeo: checks 
gosha-zt: bets $0.20
OSA_Rodeo: calls $0.20
*** RIVER *** [Js 4h Kh Th] [Kd]
OSA_Rodeo: checks 
gosha-zt: bets $2.82 and is all-in
OSA_Rodeo: calls $2.82
*** SHOW DOWN ***
gosha-zt: shows [Jh Jc] (a full house, Jacks full of Kings)
OSA_Rodeo: mucks hand 
gosha-zt collected $6.24 from pot
*** SUMMARY ***
Total pot $6.47 | Rake $0.23 
Board [Js 4h Kh Th Kd]
Seat 1: gosha-zt (button) showed [Jh Jc] and won ($6.24) with a full house, Jacks full of Kings
Seat 2: Masterc66 (small blind) folded before Flop
Seat 3: deoxy1909 (big blind) folded before Flop
Seat 4: OSA_Rodeo mucked [6h 8h]
Seat 5: martoo1003 folded before Flop (didn't bet)
Seat 6: darecripple folded before Flop (didn't bet)



PokerStars Zoom Hand #120950951004:  Hold'em No Limit ($0.01/$0.02) - 2014/09/02 9:21:48 ET
Table 'Halley' 6-max Seat #1 is the button
Seat 1: Lydomanka ($3.51 in chips) 
Seat 2: na1L19 ($0.61 in chips) 
Seat 3: deoxy1909 ($1.99 in chips) 
Seat 4: Mawhood ($2.15 in chips) 
Seat 5: willhebe ($2.23 in chips) 
Seat 6: Hazidy ($4.46 in chips) 
na1L19: posts small blind $0.01
deoxy1909: posts big blind $0.02
*** HOLE CARDS ***
Dealt to deoxy1909 [2c 4d]
Mawhood: folds 
willhebe: folds 
Hazidy: raises $0.04 to $0.06
Lydomanka: folds 
na1L19: raises $0.08 to $0.14
deoxy1909: folds 
Hazidy: calls $0.08
*** FLOP *** [8h Qs Js]
na1L19: bets $0.15
Hazidy: calls $0.15
*** TURN *** [8h Qs Js] [Jd]
na1L19: checks 
Hazidy: checks 
*** RIVER *** [8h Qs Js Jd] [Ad]
na1L19: bets $0.32 and is all-in
Hazidy: folds 
Uncalled bet ($0.32) returned to na1L19
na1L19 collected $0.58 from pot
na1L19: doesn't show hand 
*** SUMMARY ***
Total pot $0.60 | Rake $0.02 
Board [8h Qs Js Jd Ad]
Seat 1: Lydomanka (button) folded before Flop (didn't bet)
Seat 2: na1L19 (small blind) collected ($0.58)
Seat 3: deoxy1909 (big blind) folded before Flop
Seat 4: Mawhood folded before Flop (didn't bet)
Seat 5: willhebe folded before Flop (didn't bet)
Seat 6: Hazidy folded on the River



PokerStars Zoom Hand #120951211424:  Hold'em No Limit ($0.01/$0.02) - 2014/09/02 9:28:39 ET
Table 'Halley' 6-max Seat #1 is the button
Seat 1: deoxy1909 ($1.96 in chips) 
Seat 2: TerroriStgg ($1.92 in chips) 
Seat 3: K0Jlb K0JlU4 ($2.72 in chips) 
Seat 4: OldWomanSill ($2 in chips) 
Seat 5: Hackin.S ($2.30 in chips) 
Seat 6: ilonushka313 ($1.64 in chips) 
TerroriStgg: posts small blind $0.01
K0Jlb K0JlU4: posts big blind $0.02
*** HOLE CARDS ***
Dealt to deoxy1909 [8h 4h]
OldWomanSill: raises $0.02 to $0.04
Hackin.S: folds 
ilonushka313: calls $0.04
deoxy1909: folds 
TerroriStgg: folds 
K0Jlb K0JlU4: folds 
*** FLOP *** [2d 7s 5d]
OldWomanSill: bets $0.11
ilonushka313: raises $0.11 to $0.22
OldWomanSill: raises $1.74 to $1.96 and is all-in
ilonushka313: calls $1.38 and is all-in
Uncalled bet ($0.36) returned to OldWomanSill
*** TURN *** [2d 7s 5d] [Ks]
*** RIVER *** [2d 7s 5d Ks] [Qs]
*** SHOW DOWN ***
OldWomanSill: shows [8c 8s] (a pair of Eights)
ilonushka313: shows [Tc Ts] (a pair of Tens)
ilonushka313 collected $3.19 from pot
*** SUMMARY ***
Total pot $3.31 | Rake $0.12 
Board [2d 7s 5d Ks Qs]
Seat 1: deoxy1909 (button) folded before Flop (didn't bet)
Seat 2: TerroriStgg (small blind) folded before Flop
Seat 3: K0Jlb K0JlU4 (big blind) folded before Flop
Seat 4: OldWomanSill showed [8c 8s] and lost with a pair of Eights
Seat 5: Hackin.S folded before Flop (didn't bet)
Seat 6: ilonushka313 showed [Tc Ts] and won ($3.19) with a pair of Tens



PokerStars Zoom Hand #120951420149:  Hold'em No Limit ($0.01/$0.02) - 2014/09/02 9:34:07 ET
Table 'Halley' 6-max Seat #1 is the button
Seat 1: deoxy1909 ($1.93 in chips) 
Seat 2: herokall ($1.21 in chips) 
Seat 3: Cfyzy ($1.85 in chips) 
Seat 4: yeokaje ($2.37 in chips) 
Seat 5: Kare1010 ($1.01 in chips) 
Seat 6: Hattabich86 ($0.89 in chips) 
herokall: posts small blind $0.01
Cfyzy: posts big blind $0.02
*** HOLE CARDS ***
Dealt to deoxy1909 [3s Qh]
yeokaje: folds 
Kare1010: raises $0.04 to $0.06
Hattabich86: folds 
deoxy1909: folds 
herokall: folds 
Cfyzy: calls $0.04
*** FLOP *** [7d 5c Kh]
Cfyzy: bets $0.06
Kare1010: raises $0.10 to $0.16
Cfyzy: raises $0.10 to $0.26
Kare1010: raises $0.16 to $0.42
Cfyzy: calls $0.16
*** TURN *** [7d 5c Kh] [Tc]
Cfyzy: checks 
Kare1010: bets $0.53 and is all-in
Cfyzy: calls $0.53
*** RIVER *** [7d 5c Kh Tc] [2h]
*** SHOW DOWN ***
Cfyzy: shows [7c 9d] (a pair of Sevens)
Kare1010: shows [Jc Ks] (a pair of Kings)
Kare1010 collected $1.96 from pot
*** SUMMARY ***
Total pot $2.03 | Rake $0.07 
Board [7d 5c Kh Tc 2h]
Seat 1: deoxy1909 (button) folded before Flop (didn't bet)
Seat 2: herokall (small blind) folded before Flop
Seat 3: Cfyzy (big blind) showed [7c 9d] and lost with a pair of Sevens
Seat 4: yeokaje folded before Flop (didn't bet)
Seat 5: Kare1010 showed [Jc Ks] and won ($1.96) with a pair of Kings
Seat 6: Hattabich86 folded before Flop (didn't bet)



PokerStars Zoom Hand #120951480366:  Hold'em No Limit ($0.01/$0.02) - 2014/09/02 9:35:41 ET
Table 'Halley' 6-max Seat #1 is the button
Seat 1: deoxy1909 ($1.84 in chips) 
Seat 2: GRR102rus ($1.56 in chips) 
Seat 3: SNIPER67 ($4.41 in chips) 
Seat 4: Ramen9 ($2 in chips) 
Seat 5: VAN-OFFTILT ($2.38 in chips) 
Seat 6: JazzFXx ($2.37 in chips) 
GRR102rus: posts small blind $0.01
SNIPER67: posts big blind $0.02
*** HOLE CARDS ***
Dealt to deoxy1909 [7s Qd]
Ramen9: raises $0.06 to $0.08
VAN-OFFTILT: folds 
JazzFXx: folds 
deoxy1909: folds 
GRR102rus: calls $0.07
SNIPER67: folds 
*** FLOP *** [2d Th 9c]
GRR102rus: checks 
Ramen9: bets $0.12
GRR102rus: calls $0.12
*** TURN *** [2d Th 9c] [2c]
GRR102rus: checks 
Ramen9: bets $0.30
GRR102rus: calls $0.30
*** RIVER *** [2d Th 9c 2c] [8s]
GRR102rus: checks 
Ramen9: bets $0.74
GRR102rus: folds 
Uncalled bet ($0.74) returned to Ramen9
Ramen9 collected $0.98 from pot
Ramen9: doesn't show hand 
*** SUMMARY ***
Total pot $1.02 | Rake $0.04 
Board [2d Th 9c 2c 8s]
Seat 1: deoxy1909 (button) folded before Flop (didn't bet)
Seat 2: GRR102rus (small blind) folded on the River
Seat 3: SNIPER67 (big blind) folded before Flop
Seat 4: Ramen9 collected ($0.98)
Seat 5: VAN-OFFTILT folded before Flop (didn't bet)
Seat 6: JazzFXx folded before Flop (didn't bet)



PokerStars Zoom Hand #120951545109:  Hold'em No Limit ($0.01/$0.02) - 2014/09/02 9:37:22 ET
Table 'Halley' 6-max Seat #1 is the button
Seat 1: deoxy1909 ($1.72 in chips) 
Seat 2: and5003 ($3.44 in chips) 
Seat 3: OeTen101 ($2 in chips) 
Seat 4: Vodkareva ($1.07 in chips) 
Seat 5: flipforstack ($2.10 in chips) 
Seat 6: VivienC ($2.17 in chips) 
and5003: posts small blind $0.01
OeTen101: posts big blind $0.02
*** HOLE CARDS ***
Dealt to deoxy1909 [Qc 3d]
Vodkareva: raises $0.04 to $0.06
flipforstack: folds 
VivienC: folds 
deoxy1909: folds 
and5003: calls $0.05
OeTen101: folds 
*** FLOP *** [5d Qs Qd]
and5003: checks 
Vodkareva: checks 
*** TURN *** [5d Qs Qd] [6h]
and5003: bets $0.10
Vodkareva: calls $0.10
*** RIVER *** [5d Qs Qd 6h] [9s]
and5003: bets $0.24
Vodkareva: calls $0.24
*** SHOW DOWN ***
and5003: shows [Ks Js] (a pair of Queens)
Vodkareva: shows [8s 8d] (two pair, Queens and Eights)
Vodkareva collected $0.79 from pot
*** SUMMARY ***
Total pot $0.82 | Rake $0.03 
Board [5d Qs Qd 6h 9s]
Seat 1: deoxy1909 (button) folded before Flop (didn't bet)
Seat 2: and5003 (small blind) showed [Ks Js] and lost with a pair of Queens
Seat 3: OeTen101 (big blind) folded before Flop
Seat 4: Vodkareva showed [8s 8d] and won ($0.79) with two pair, Queens and Eights
Seat 5: flipforstack folded before Flop (didn't bet)
Seat 6: VivienC folded before Flop (didn't bet)



PokerStars Zoom Hand #120951752757:  Hold'em No Limit ($0.01/$0.02) - 2014/09/02 9:42:43 ET
Table 'Halley' 6-max Seat #1 is the button
Seat 1: IZOPOL ($0.89 in chips) 
Seat 2: Eustahije222 ($3.30 in chips) 
Seat 3: deoxy1909 ($1.70 in chips) 
Seat 4: Rake Victim ($2.21 in chips) 
Seat 5: Matrix2015 ($2.03 in chips) 
Seat 6: Vollos ($2.04 in chips) 
Eustahije222: posts small blind $0.01
deoxy1909: posts big blind $0.02
*** HOLE CARDS ***
Dealt to deoxy1909 [Ah 8h]
Rake Victim: folds 
Matrix2015: folds 
Vollos: folds 
IZOPOL: raises $0.02 to $0.04
Eustahije222: raises $0.10 to $0.14
deoxy1909: folds 
IZOPOL: calls $0.10
*** FLOP *** [9s 7c Kh]
Eustahije222: checks 
IZOPOL: checks 
*** TURN *** [9s 7c Kh] [2h]
Eustahije222: bets $0.18
IZOPOL: calls $0.18
*** RIVER *** [9s 7c Kh 2h] [5h]
Eustahije222: checks 
IZOPOL: checks 
*** SHOW DOWN ***
Eustahije222: shows [Jc Jh] (a pair of Jacks)
IZOPOL: mucks hand 
Eustahije222 collected $0.64 from pot
*** SUMMARY ***
Total pot $0.66 | Rake $0.02 
Board [9s 7c Kh 2h 5h]
Seat 1: IZOPOL (button) mucked [3c 3h]
Seat 2: Eustahije222 (small blind) showed [Jc Jh] and won ($0.64) with a pair of Jacks
Seat 3: deoxy1909 (big blind) folded before Flop
Seat 4: Rake Victim folded before Flop (didn't bet)
Seat 5: Matrix2015 folded before Flop (didn't bet)
Seat 6: Vollos folded before Flop (didn't bet)



PokerStars Zoom Hand #120952194837:  Hold'em No Limit ($0.01/$0.02) - 2014/09/02 9:54:05 ET
Table 'Halley' 6-max Seat #1 is the button
Seat 1: nLzWALK ($1.33 in chips) 
Seat 2: MiroM111 ($3.30 in chips) 
Seat 3: smahatma ($2.59 in chips) 
Seat 4: deoxy1909 ($1.36 in chips) 
Seat 5: Moremiik ($1.77 in chips) 
Seat 6: migaczyk ($3.92 in chips) 
MiroM111: posts small blind $0.01
smahatma: posts big blind $0.02
*** HOLE CARDS ***
Dealt to deoxy1909 [Ah Td]
deoxy1909: raises $0.04 to $0.06
Moremiik: folds 
migaczyk: folds 
nLzWALK: folds 
MiroM111: calls $0.05
smahatma: folds 
*** FLOP *** [9h Th Qd]
MiroM111: bets $0.02
deoxy1909: calls $0.02
*** TURN *** [9h Th Qd] [As]
MiroM111: bets $0.08
deoxy1909: raises $0.10 to $0.18
MiroM111: calls $0.10
*** RIVER *** [9h Th Qd As] [8h]
MiroM111: checks 
deoxy1909: checks 
*** SHOW DOWN ***
MiroM111: shows [Kc 9d] (a pair of Nines)
deoxy1909: shows [Ah Td] (two pair, Aces and Tens)
deoxy1909 collected $0.52 from pot
*** SUMMARY ***
Total pot $0.54 | Rake $0.02 
Board [9h Th Qd As 8h]
Seat 1: nLzWALK (button) folded before Flop (didn't bet)
Seat 2: MiroM111 (small blind) showed [Kc 9d] and lost with a pair of Nines
Seat 3: smahatma (big blind) folded before Flop
Seat 4: deoxy1909 showed [Ah Td] and won ($0.52) with two pair, Aces and Tens
Seat 5: Moremiik folded before Flop (didn't bet)
Seat 6: migaczyk folded before Flop (didn't bet)



PokerStars Zoom Hand #120952242063:  Hold'em No Limit ($0.01/$0.02) - 2014/09/02 9:55:21 ET
Table 'Halley' 6-max Seat #1 is the button
Seat 1: callmeplz935 ($4.64 in chips) 
Seat 2: BigSlava423 ($1.72 in chips) 
Seat 3: deoxy1909 ($1.70 in chips) 
Seat 4: audiak ($2 in chips) 
Seat 5: rotta@poker ($2.21 in chips) 
Seat 6: marrrx ($4.96 in chips) 
BigSlava423: posts small blind $0.01
deoxy1909: posts big blind $0.02
*** HOLE CARDS ***
Dealt to deoxy1909 [Qd 6h]
audiak: folds 
rotta@poker: folds 
marrrx: folds 
callmeplz935: raises $0.04 to $0.06
BigSlava423: calls $0.05
deoxy1909: folds 
*** FLOP *** [Ah 8d 6s]
BigSlava423: bets $0.06
callmeplz935: calls $0.06
*** TURN *** [Ah 8d 6s] [Tc]
BigSlava423: bets $0.12
callmeplz935: calls $0.12
*** RIVER *** [Ah 8d 6s Tc] [Td]
BigSlava423: bets $0.24
callmeplz935: calls $0.24
*** SHOW DOWN ***
BigSlava423: shows [Jh Th] (three of a kind, Tens)
callmeplz935: mucks hand 
BigSlava423 collected $0.95 from pot
*** SUMMARY ***
Total pot $0.98 | Rake $0.03 
Board [Ah 8d 6s Tc Td]
Seat 1: callmeplz935 (button) mucked [Js As]
Seat 2: BigSlava423 (small blind) showed [Jh Th] and won ($0.95) with three of a kind, Tens
Seat 3: deoxy1909 (big blind) folded before Flop
Seat 4: audiak folded before Flop (didn't bet)
Seat 5: rotta@poker folded before Flop (didn't bet)
Seat 6: marrrx folded before Flop (didn't bet)



PokerStars Zoom Hand #120952260406:  Hold'em No Limit ($0.01/$0.02) - 2014/09/02 9:55:56 ET
Table 'Halley' 6-max Seat #1 is the button
Seat 1: deoxy1909 ($1.67 in chips) 
Seat 2: Panda0777 ($1.25 in chips) 
Seat 3: magyfe ($1 in chips) 
Seat 4: deathrazor ($3.31 in chips) 
Seat 5: *L4dyZAsteR* ($3.51 in chips) 
Seat 6: Dav1dos ($2.46 in chips) 
Panda0777: posts small blind $0.01
magyfe: posts big blind $0.02
*** HOLE CARDS ***
Dealt to deoxy1909 [9h Js]
deathrazor: folds 
*L4dyZAsteR*: raises $0.04 to $0.06
Dav1dos: folds 
deoxy1909: folds 
Panda0777: folds 
magyfe: calls $0.04
*** FLOP *** [Td 2h Ad]
magyfe: checks 
*L4dyZAsteR*: bets $0.08
magyfe: raises $0.86 to $0.94 and is all-in
*L4dyZAsteR*: calls $0.86
*** TURN *** [Td 2h Ad] [2s]
*** RIVER *** [Td 2h Ad 2s] [Jh]
*** SHOW DOWN ***
magyfe: shows [Ts Ah] (two pair, Aces and Tens)
*L4dyZAsteR*: shows [Ac Kd] (two pair, Aces and Deuces)
magyfe collected $1.94 from pot
*** SUMMARY ***
Total pot $2.01 | Rake $0.07 
Board [Td 2h Ad 2s Jh]
Seat 1: deoxy1909 (button) folded before Flop (didn't bet)
Seat 2: Panda0777 (small blind) folded before Flop
Seat 3: magyfe (big blind) showed [Ts Ah] and won ($1.94) with two pair, Aces and Tens
Seat 4: deathrazor folded before Flop (didn't bet)
Seat 5: *L4dyZAsteR* showed [Ac Kd] and lost with two pair, Aces and Deuces
Seat 6: Dav1dos folded before Flop (didn't bet)



PokerStars Zoom Hand #120952306912:  Hold'em No Limit ($0.01/$0.02) - 2014/09/02 9:57:24 ET
Table 'Halley' 6-max Seat #1 is the button
Seat 1: mixjuice ($2.09 in chips) 
Seat 2: irepela ($5.95 in chips) 
Seat 3: MrHobit ($2.49 in chips) 
Seat 4: deoxy1909 ($1.64 in chips) 
Seat 5: mefficial ($2.83 in chips) 
Seat 6: K1ngInHell ($2.25 in chips) 
irepela: posts small blind $0.01
MrHobit: posts big blind $0.02
*** HOLE CARDS ***
Dealt to deoxy1909 [Jd Qd]
deoxy1909: raises $0.04 to $0.06
mefficial: folds 
K1ngInHell: folds 
mixjuice: calls $0.06
irepela: folds 
MrHobit: folds 
*** FLOP *** [8c Qh 6s]
deoxy1909: bets $0.10
mixjuice: calls $0.10
*** TURN *** [8c Qh 6s] [3d]
deoxy1909: bets $0.24
mixjuice: raises $0.30 to $0.54
deoxy1909: raises $0.94 to $1.48 and is all-in
mixjuice: calls $0.94
*** FIRST RIVER *** [8c Qh 6s 3d] [Kd]
*** SECOND RIVER *** [8c Qh 6s 3d] [8h]
*** FIRST SHOW DOWN ***
deoxy1909: shows [Jd Qd] (a pair of Queens)
mixjuice: shows [8d 8s] (three of a kind, Eights)
mixjuice collected $1.60 from pot
*** SECOND SHOW DOWN ***
deoxy1909: shows [Jd Qd] (two pair, Queens and Eights)
mixjuice: shows [8d 8s] (four of a kind, Eights)
mixjuice collected $1.59 from pot
*** SUMMARY ***
Total pot $3.31 | Rake $0.12 
Hand was run twice
FIRST Board [8c Qh 6s 3d Kd]
SECOND Board [8c Qh 6s 3d 8h]
Seat 1: mixjuice (button) showed [8d 8s] and won ($1.60) with three of a kind, Eights, and won ($1.59) with four of a kind, Eights
Seat 2: irepela (small blind) folded before Flop
Seat 3: MrHobit (big blind) folded before Flop
Seat 4: deoxy1909 showed [Jd Qd] and lost with a pair of Queens, and lost with two pair, Queens and Eights
Seat 5: mefficial folded before Flop (didn't bet)
Seat 6: K1ngInHell folded before Flop (didn't bet)



PokerStars Zoom Hand #120961758255:  Hold'em No Limit ($0.01/$0.02) - 2014/09/02 13:31:07 ET
Table 'Halley' 6-max Seat #1 is the button
Seat 1: bandziorno81 ($3.23 in chips) 
Seat 2: roncrx ($2 in chips) 
Seat 3: deoxy1909 ($1.94 in chips) 
Seat 4: teddynko66 ($4.65 in chips) 
Seat 5: the ipate ($2 in chips) 
Seat 6: The Maxxie ($2 in chips) 
roncrx: posts small blind $0.01
deoxy1909: posts big blind $0.02
*** HOLE CARDS ***
Dealt to deoxy1909 [7c Tc]
teddynko66: folds 
the ipate: calls $0.02
The Maxxie: raises $0.06 to $0.08
bandziorno81: folds 
roncrx: folds 
deoxy1909: folds 
the ipate: raises $0.06 to $0.14
The Maxxie: calls $0.06
*** FLOP *** [9d Js 9s]
the ipate: checks 
The Maxxie: checks 
*** TURN *** [9d Js 9s] [Qd]
the ipate: bets $0.30
The Maxxie: calls $0.30
*** RIVER *** [9d Js 9s Qd] [2h]
the ipate: bets $0.88
The Maxxie: calls $0.88
*** SHOW DOWN ***
the ipate: shows [Kd Kc] (two pair, Kings and Nines)
The Maxxie: mucks hand 
the ipate collected $2.58 from pot
*** SUMMARY ***
Total pot $2.67 | Rake $0.09 
Board [9d Js 9s Qd 2h]
Seat 1: bandziorno81 (button) folded before Flop (didn't bet)
Seat 2: roncrx (small blind) folded before Flop
Seat 3: deoxy1909 (big blind) folded before Flop
Seat 4: teddynko66 folded before Flop (didn't bet)
Seat 5: the ipate showed [Kd Kc] and won ($2.58) with two pair, Kings and Nines
Seat 6: The Maxxie mucked [Qc Ah]



PokerStars Zoom Hand #120962115989:  Hold'em No Limit ($0.01/$0.02) - 2014/09/02 13:38:08 ET
Table 'Halley' 6-max Seat #1 is the button
Seat 1: patxer ($2 in chips) 
Seat 2: Tsikipauväu ($2.01 in chips) 
Seat 3: deoxy1909 ($1.88 in chips) 
Seat 4: RoyalJony ($1.42 in chips) 
Seat 5: lativ345 ($5.34 in chips) 
Seat 6: cashbags ($2.32 in chips) 
Tsikipauväu: posts small blind $0.01
deoxy1909: posts big blind $0.02
*** HOLE CARDS ***
Dealt to deoxy1909 [6d 3s]
RoyalJony: raises $0.04 to $0.06
lativ345: folds 
cashbags: folds 
patxer: folds 
Tsikipauväu: calls $0.05
deoxy1909: folds 
*** FLOP *** [6s Ks Ad]
Tsikipauväu: checks 
RoyalJony: checks 
*** TURN *** [6s Ks Ad] [2h]
Tsikipauväu: bets $0.06
RoyalJony: raises $0.13 to $0.19
Tsikipauväu: calls $0.13
*** RIVER *** [6s Ks Ad 2h] [7c]
Tsikipauväu: checks 
RoyalJony: bets $0.50
Tsikipauväu: folds 
Uncalled bet ($0.50) returned to RoyalJony
RoyalJony collected $0.50 from pot
RoyalJony: doesn't show hand 
*** SUMMARY ***
Total pot $0.52 | Rake $0.02 
Board [6s Ks Ad 2h 7c]
Seat 1: patxer (button) folded before Flop (didn't bet)
Seat 2: Tsikipauväu (small blind) folded on the River
Seat 3: deoxy1909 (big blind) folded before Flop
Seat 4: RoyalJony collected ($0.50)
Seat 5: lativ345 folded before Flop (didn't bet)
Seat 6: cashbags folded before Flop (didn't bet)



PokerStars Zoom Hand #120962134917:  Hold'em No Limit ($0.01/$0.02) - 2014/09/02 13:38:30 ET
Table 'Halley' 6-max Seat #1 is the button
Seat 1: deoxy1909 ($1.85 in chips) 
Seat 2: 0bie1 ($3.06 in chips) 
Seat 3: DavidMKS ($1.93 in chips) 
Seat 4: pasparty ($2.79 in chips) 
Seat 5: iosif_krd ($2.16 in chips) 
Seat 6: StilerNAw ($0.65 in chips) 
0bie1: posts small blind $0.01
DavidMKS: posts big blind $0.02
*** HOLE CARDS ***
Dealt to deoxy1909 [7h 8h]
pasparty: raises $0.04 to $0.06
iosif_krd: calls $0.06
StilerNAw: folds 
deoxy1909: folds 
0bie1: raises $0.17 to $0.23
DavidMKS: folds 
pasparty: folds 
iosif_krd: calls $0.17
*** FLOP *** [4c 7c Js]
0bie1: bets $0.33
iosif_krd: calls $0.33
*** TURN *** [4c 7c Js] [8s]
0bie1: bets $0.66
iosif_krd: raises $0.94 to $1.60 and is all-in
0bie1: calls $0.94
*** RIVER *** [4c 7c Js 8s] [5d]
*** SHOW DOWN ***
0bie1: shows [Kd Kh] (a pair of Kings)
iosif_krd: mucks hand 
0bie1 collected $4.25 from pot
*** SUMMARY ***
Total pot $4.40 | Rake $0.15 
Board [4c 7c Js 8s 5d]
Seat 1: deoxy1909 (button) folded before Flop (didn't bet)
Seat 2: 0bie1 (small blind) showed [Kd Kh] and won ($4.25) with a pair of Kings
Seat 3: DavidMKS (big blind) folded before Flop
Seat 4: pasparty folded before Flop
Seat 5: iosif_krd mucked [2s Ks]
Seat 6: StilerNAw folded before Flop (didn't bet)



PokerStars Zoom Hand #120962167067:  Hold'em No Limit ($0.01/$0.02) - 2014/09/02 13:39:08 ET
Table 'Halley' 6-max Seat #1 is the button
Seat 1: deoxy1909 ($1.88 in chips) 
Seat 2: Tn 939 ($2.15 in chips) 
Seat 3: Damon7777 ($4.75 in chips) 
Seat 4: lbe81 ($1.83 in chips) 
Seat 5: iluha24 ($1.03 in chips) 
Seat 6: the_smokerrr ($8.43 in chips) 
Tn 939: posts small blind $0.01
Damon7777: posts big blind $0.02
*** HOLE CARDS ***
Dealt to deoxy1909 [9s Ac]
lbe81: raises $0.02 to $0.04
iluha24: folds 
the_smokerrr: folds 
deoxy1909: calls $0.04
Tn 939: folds 
Damon7777: folds 
*** FLOP *** [6h 9d 8s]
lbe81: checks 
deoxy1909: bets $0.06
lbe81: calls $0.06
*** TURN *** [6h 9d 8s] [6d]
lbe81: checks 
deoxy1909: bets $0.16
lbe81: raises $0.28 to $0.44
deoxy1909: folds 
Uncalled bet ($0.28) returned to lbe81
lbe81 collected $0.53 from pot
lbe81: doesn't show hand 
*** SUMMARY ***
Total pot $0.55 | Rake $0.02 
Board [6h 9d 8s 6d]
Seat 1: deoxy1909 (button) folded on the Turn
Seat 2: Tn 939 (small blind) folded before Flop
Seat 3: Damon7777 (big blind) folded before Flop
Seat 4: lbe81 collected ($0.53)
Seat 5: iluha24 folded before Flop (didn't bet)
Seat 6: the_smokerrr folded before Flop (didn't bet)



PokerStars Zoom Hand #120962229216:  Hold'em No Limit ($0.01/$0.02) - 2014/09/02 13:40:21 ET
Table 'Halley' 6-max Seat #1 is the button
Seat 1: K.A.Narain ($1.96 in chips) 
Seat 2: koki1331 ($2.75 in chips) 
Seat 3: deoxy1909 ($1.59 in chips) 
Seat 4: DeAurelia ($2.01 in chips) 
Seat 5: Alex Anima ($2.48 in chips) 
Seat 6: prop4uk11 ($3.49 in chips) 
koki1331: posts small blind $0.01
deoxy1909: posts big blind $0.02
*** HOLE CARDS ***
Dealt to deoxy1909 [6s 4c]
DeAurelia: raises $0.02 to $0.04
Alex Anima: folds 
prop4uk11: raises $0.06 to $0.10
K.A.Narain: calls $0.10
koki1331: folds 
deoxy1909: folds 
DeAurelia: calls $0.06
*** FLOP *** [2h 7s Tc]
DeAurelia: checks 
prop4uk11: bets $0.21
K.A.Narain: calls $0.21
DeAurelia: calls $0.21
*** TURN *** [2h 7s Tc] [4d]
DeAurelia: checks 
prop4uk11: bets $0.61
K.A.Narain: folds 
DeAurelia: calls $0.61
*** RIVER *** [2h 7s Tc 4d] [As]
DeAurelia: checks 
prop4uk11: checks 
*** SHOW DOWN ***
DeAurelia: shows [7d 7c] (three of a kind, Sevens)
prop4uk11: mucks hand 
DeAurelia collected $2.10 from pot
*** SUMMARY ***
Total pot $2.18 | Rake $0.08 
Board [2h 7s Tc 4d As]
Seat 1: K.A.Narain (button) folded on the Turn
Seat 2: koki1331 (small blind) folded before Flop
Seat 3: deoxy1909 (big blind) folded before Flop
Seat 4: DeAurelia showed [7d 7c] and won ($2.10) with three of a kind, Sevens
Seat 5: Alex Anima folded before Flop (didn't bet)
Seat 6: prop4uk11 mucked [Qs Qc]



PokerStars Zoom Hand #120962531294:  Hold'em No Limit ($0.01/$0.02) - 2014/09/02 13:46:15 ET
Table 'Halley' 6-max Seat #1 is the button
Seat 1: deoxy1909 ($1.38 in chips) 
Seat 2: Hellboy8x ($1.88 in chips) 
Seat 3: legionofttx ($1 in chips) 
Seat 4: Welshdave85 ($2.92 in chips) 
Seat 5: S.V.K.1970 ($1.86 in chips) 
Seat 6: FishOnPlate ($2 in chips) 
Hellboy8x: posts small blind $0.01
legionofttx: posts big blind $0.02
*** HOLE CARDS ***
Dealt to deoxy1909 [Jh Kd]
Welshdave85: folds 
S.V.K.1970: raises $0.02 to $0.04
FishOnPlate: folds 
deoxy1909: calls $0.04
Hellboy8x: folds 
legionofttx: calls $0.02
*** FLOP *** [Js 5s 7d]
legionofttx: checks 
S.V.K.1970: checks 
deoxy1909: bets $0.08
legionofttx: folds 
S.V.K.1970: raises $0.08 to $0.16
deoxy1909: calls $0.08
*** TURN *** [Js 5s 7d] [Ks]
S.V.K.1970: bets $0.16
deoxy1909: raises $0.30 to $0.46
S.V.K.1970: raises $0.30 to $0.76
deoxy1909: calls $0.30
*** RIVER *** [Js 5s 7d Ks] [Th]
S.V.K.1970: bets $0.42
deoxy1909: calls $0.42 and is all-in
*** SHOW DOWN ***
S.V.K.1970: shows [7c Ac] (a pair of Sevens)
deoxy1909: shows [Jh Kd] (two pair, Kings and Jacks)
deoxy1909 collected $2.71 from pot
*** SUMMARY ***
Total pot $2.81 | Rake $0.10 
Board [Js 5s 7d Ks Th]
Seat 1: deoxy1909 (button) showed [Jh Kd] and won ($2.71) with two pair, Kings and Jacks
Seat 2: Hellboy8x (small blind) folded before Flop
Seat 3: legionofttx (big blind) folded on the Flop
Seat 4: Welshdave85 folded before Flop (didn't bet)
Seat 5: S.V.K.1970 showed [7c Ac] and lost with a pair of Sevens
Seat 6: FishOnPlate folded before Flop (didn't bet)



PokerStars Zoom Hand #120964564854:  Hold'em No Limit ($0.01/$0.02) - 2014/09/02 14:25:29 ET
Table 'Halley' 6-max Seat #1 is the button
Seat 1: deoxy1909 ($2.26 in chips) 
Seat 2: spacer510 ($3.16 in chips) 
Seat 3: yapojoshe ($1 in chips) 
Seat 4: 777.A.C.A.B. ($0.57 in chips) 
Seat 5: FezzGeraldo ($1.98 in chips) 
Seat 6: Külzi ($1.62 in chips) 
spacer510: posts small blind $0.01
yapojoshe: posts big blind $0.02
*** HOLE CARDS ***
Dealt to deoxy1909 [Jd Kd]
777.A.C.A.B.: folds 
FezzGeraldo: calls $0.02
Külzi: calls $0.02
deoxy1909: raises $0.08 to $0.10
spacer510: calls $0.09
yapojoshe: folds 
FezzGeraldo: folds 
Külzi: calls $0.08
*** FLOP *** [9c 2c 3d]
spacer510: checks 
Külzi: checks 
deoxy1909: checks 
*** TURN *** [9c 2c 3d] [Td]
spacer510: checks 
Külzi: checks 
deoxy1909: checks 
*** RIVER *** [9c 2c 3d Td] [5h]
spacer510: bets $0.16
Külzi: raises $0.22 to $0.38
deoxy1909: folds 
spacer510: raises $0.54 to $0.92
Külzi: raises $0.60 to $1.52 and is all-in
spacer510: calls $0.60
*** SHOW DOWN ***
Külzi: shows [5c 5d] (three of a kind, Fives)
spacer510: shows [6c 4c] (a straight, Deuce to Six)
spacer510 collected $3.26 from pot
*** SUMMARY ***
Total pot $3.38 | Rake $0.12 
Board [9c 2c 3d Td 5h]
Seat 1: deoxy1909 (button) folded on the River
Seat 2: spacer510 (small blind) showed [6c 4c] and won ($3.26) with a straight, Deuce to Six
Seat 3: yapojoshe (big blind) folded before Flop
Seat 4: 777.A.C.A.B. folded before Flop (didn't bet)
Seat 5: FezzGeraldo folded before Flop
Seat 6: Külzi showed [5c 5d] and lost with three of a kind, Fives



PokerStars Zoom Hand #120964697031:  Hold'em No Limit ($0.01/$0.02) - 2014/09/02 14:27:54 ET
Table 'Halley' 6-max Seat #1 is the button
Seat 1: HomoCanabis ($0.84 in chips) 
Seat 2: deoxy1909 ($2.10 in chips) 
Seat 3: bouncg ($1.71 in chips) 
Seat 4: sbela23 ($5.68 in chips) 
Seat 5: MiVidaLoca33 ($2.19 in chips) 
Seat 6: Sark123321 ($1.50 in chips) 
deoxy1909: posts small blind $0.01
bouncg: posts big blind $0.02
*** HOLE CARDS ***
Dealt to deoxy1909 [6c 7d]
sbela23: folds 
MiVidaLoca33: folds 
Sark123321: raises $0.04 to $0.06
HomoCanabis: folds 
deoxy1909: folds 
bouncg: raises $0.09 to $0.15
Sark123321: calls $0.09
*** FLOP *** [6h Tc 6d]
bouncg: bets $0.12
Sark123321: raises $0.12 to $0.24
bouncg: calls $0.12
*** TURN *** [6h Tc 6d] [As]
bouncg: checks 
Sark123321: checks 
*** RIVER *** [6h Tc 6d As] [9h]
bouncg: bets $1.32 and is all-in
Sark123321: folds 
Uncalled bet ($1.32) returned to bouncg
bouncg collected $0.76 from pot
bouncg: doesn't show hand 
*** SUMMARY ***
Total pot $0.79 | Rake $0.03 
Board [6h Tc 6d As 9h]
Seat 1: HomoCanabis (button) folded before Flop (didn't bet)
Seat 2: deoxy1909 (small blind) folded before Flop
Seat 3: bouncg (big blind) collected ($0.76)
Seat 4: sbela23 folded before Flop (didn't bet)
Seat 5: MiVidaLoca33 folded before Flop (didn't bet)
Seat 6: Sark123321 folded on the River



PokerStars Zoom Hand #120964824410:  Hold'em No Limit ($0.01/$0.02) - 2014/09/02 14:30:13 ET
Table 'Halley' 6-max Seat #1 is the button
Seat 1: Wozny666 ($2.46 in chips) 
Seat 2: In$an3[GER] ($2.12 in chips) 
Seat 3: deoxy1909 ($2.51 in chips) 
Seat 4: Slava649 ($1.22 in chips) 
Seat 5: canybomba ($0.42 in chips) 
Seat 6: frostielolz ($2 in chips) 
In$an3[GER]: posts small blind $0.01
deoxy1909: posts big blind $0.02
*** HOLE CARDS ***
Dealt to deoxy1909 [Ks 8c]
Slava649: folds 
canybomba: folds 
frostielolz: folds 
Wozny666: raises $0.03 to $0.05
In$an3[GER]: raises $0.13 to $0.18
deoxy1909: folds 
Wozny666: calls $0.13
*** FLOP *** [Ac 9d Qs]
In$an3[GER]: bets $0.18
Wozny666: raises $0.18 to $0.36
In$an3[GER]: calls $0.18
*** TURN *** [Ac 9d Qs] [8d]
In$an3[GER]: checks 
Wozny666: checks 
*** RIVER *** [Ac 9d Qs 8d] [Kd]
In$an3[GER]: bets $0.33
Wozny666: folds 
Uncalled bet ($0.33) returned to In$an3[GER]
In$an3[GER] collected $1.06 from pot
In$an3[GER]: doesn't show hand 
*** SUMMARY ***
Total pot $1.10 | Rake $0.04 
Board [Ac 9d Qs 8d Kd]
Seat 1: Wozny666 (button) folded on the River
Seat 2: In$an3[GER] (small blind) collected ($1.06)
Seat 3: deoxy1909 (big blind) folded before Flop
Seat 4: Slava649 folded before Flop (didn't bet)
Seat 5: canybomba folded before Flop (didn't bet)
Seat 6: frostielolz folded before Flop (didn't bet)



PokerStars Zoom Hand #120964953603:  Hold'em No Limit ($0.01/$0.02) - 2014/09/02 14:32:33 ET
Table 'Halley' 6-max Seat #1 is the button
Seat 1: Arcaniya ($6.67 in chips) 
Seat 2: deoxy1909 ($2.57 in chips) 
Seat 3: Wowochka ($0.91 in chips) 
Seat 4: zuzukala ($2.40 in chips) 
Seat 5: KOTYRA190 ($1.73 in chips) 
Seat 6: Sintac ($3.09 in chips) 
deoxy1909: posts small blind $0.01
Wowochka: posts big blind $0.02
*** HOLE CARDS ***
Dealt to deoxy1909 [Jc 3s]
zuzukala: raises $0.04 to $0.06
KOTYRA190: calls $0.06
Sintac: folds 
Arcaniya: raises $0.26 to $0.32
deoxy1909: folds 
Wowochka: folds 
zuzukala: folds 
KOTYRA190: calls $0.26
*** FLOP *** [6s 4h Qc]
KOTYRA190: checks 
Arcaniya: checks 
*** TURN *** [6s 4h Qc] [Kc]
KOTYRA190: checks 
Arcaniya: bets $0.48
KOTYRA190: calls $0.48
*** RIVER *** [6s 4h Qc Kc] [5c]
KOTYRA190: checks 
Arcaniya: bets $1
KOTYRA190: folds 
Uncalled bet ($1) returned to Arcaniya
Arcaniya collected $1.63 from pot
Arcaniya: doesn't show hand 
*** SUMMARY ***
Total pot $1.69 | Rake $0.06 
Board [6s 4h Qc Kc 5c]
Seat 1: Arcaniya (button) collected ($1.63)
Seat 2: deoxy1909 (small blind) folded before Flop
Seat 3: Wowochka (big blind) folded before Flop
Seat 4: zuzukala folded before Flop
Seat 5: KOTYRA190 folded on the River
Seat 6: Sintac folded before Flop (didn't bet)



PokerStars Zoom Hand #120964991455:  Hold'em No Limit ($0.01/$0.02) - 2014/09/02 14:33:14 ET
Table 'Halley' 6-max Seat #1 is the button
Seat 1: hakkerss ($2.03 in chips) 
Seat 2: deoxy1909 ($2.57 in chips) 
Seat 3: Ymnica15 ($2.34 in chips) 
Seat 4: ice_allen ($2.29 in chips) 
Seat 5: ludgero 555 ($0.66 in chips) 
Seat 6: BABS217 ($1.86 in chips) 
deoxy1909: posts small blind $0.01
Ymnica15: posts big blind $0.02
*** HOLE CARDS ***
Dealt to deoxy1909 [Js Ad]
ice_allen: folds 
ludgero 555 has timed out
ludgero 555: folds 
BABS217: folds 
hakkerss: raises $0.14 to $0.16
deoxy1909: calls $0.15
Ymnica15: folds 
*** FLOP *** [Jd As 2c]
deoxy1909: bets $0.24
hakkerss: calls $0.24
*** TURN *** [Jd As 2c] [Kh]
deoxy1909: bets $0.60
hakkerss: calls $0.60
*** RIVER *** [Jd As 2c Kh] [7h]
deoxy1909: bets $1.57 and is all-in
hakkerss: folds 
Uncalled bet ($1.57) returned to deoxy1909
deoxy1909 collected $1.95 from pot
deoxy1909: doesn't show hand 
*** SUMMARY ***
Total pot $2.02 | Rake $0.07 
Board [Jd As 2c Kh 7h]
Seat 1: hakkerss (button) folded on the River
Seat 2: deoxy1909 (small blind) collected ($1.95)
Seat 3: Ymnica15 (big blind) folded before Flop
Seat 4: ice_allen folded before Flop (didn't bet)
Seat 5: ludgero 555 folded before Flop (didn't bet)
Seat 6: BABS217 folded before Flop (didn't bet)



PokerStars Zoom Hand #120986738787:  Hold'em No Limit ($0.01/$0.02) - 2014/09/02 23:46:42 ET
Table 'Halley' 6-max Seat #1 is the button
Seat 1: hagerci ($2.28 in chips) 
Seat 2: bloodik2k ($2.26 in chips) 
Seat 3: sakippo ($2.99 in chips) 
Seat 4: deoxy1909 ($2 in chips) 
Seat 5: ryeguy888 ($0.55 in chips) 
Seat 6: Gorg Sheller ($3.70 in chips) 
bloodik2k: posts small blind $0.01
sakippo: posts big blind $0.02
*** HOLE CARDS ***
Dealt to deoxy1909 [Kc Jd]
deoxy1909: raises $0.04 to $0.06
ryeguy888: folds 
Gorg Sheller: folds 
hagerci: folds 
bloodik2k: calls $0.05
sakippo: folds 
*** FLOP *** [8c Jh Th]
bloodik2k: checks 
deoxy1909: bets $0.08
bloodik2k: calls $0.08
*** TURN *** [8c Jh Th] [6s]
bloodik2k: bets $0.14
deoxy1909: calls $0.14
*** RIVER *** [8c Jh Th 6s] [2d]
bloodik2k: bets $0.28
deoxy1909: calls $0.28
*** SHOW DOWN ***
bloodik2k: shows [Ts 4d] (a pair of Tens)
deoxy1909: shows [Kc Jd] (a pair of Jacks)
deoxy1909 collected $1.10 from pot
*** SUMMARY ***
Total pot $1.14 | Rake $0.04 
Board [8c Jh Th 6s 2d]
Seat 1: hagerci (button) folded before Flop (didn't bet)
Seat 2: bloodik2k (small blind) showed [Ts 4d] and lost with a pair of Tens
Seat 3: sakippo (big blind) folded before Flop
Seat 4: deoxy1909 showed [Kc Jd] and won ($1.10) with a pair of Jacks
Seat 5: ryeguy888 folded before Flop (didn't bet)
Seat 6: Gorg Sheller folded before Flop (didn't bet)



PokerStars Zoom Hand #120986749278:  Hold'em No Limit ($0.01/$0.02) - 2014/09/02 23:47:20 ET
Table 'Halley' 6-max Seat #1 is the button
Seat 1: alphA_hAnds ($4.14 in chips) 
Seat 2: Ape2012 ($1.18 in chips) 
Seat 3: deoxy1909 ($2.54 in chips) 
Seat 4: aguilar_8514 ($2.92 in chips) 
Seat 5: UA_RUS_7891 ($2.73 in chips) 
Seat 6: KOSTYA STARK ($1.75 in chips) 
Ape2012: posts small blind $0.01
deoxy1909: posts big blind $0.02
*** HOLE CARDS ***
Dealt to deoxy1909 [Ad Ah]
aguilar_8514: folds 
UA_RUS_7891: folds 
KOSTYA STARK: raises $0.04 to $0.06
alphA_hAnds: raises $0.08 to $0.14
Ape2012: folds 
deoxy1909: raises $0.28 to $0.42
KOSTYA STARK: calls $0.36
alphA_hAnds: folds 
*** FLOP *** [2h 7c 3s]
deoxy1909: bets $0.72
KOSTYA STARK: calls $0.72
*** TURN *** [2h 7c 3s] [Kd]
deoxy1909: bets $1.40 and is all-in
KOSTYA STARK: calls $0.61 and is all-in
Uncalled bet ($0.79) returned to deoxy1909
*** RIVER *** [2h 7c 3s Kd] [4c]
*** SHOW DOWN ***
deoxy1909: shows [Ad Ah] (a pair of Aces)
KOSTYA STARK: shows [Qs Ts] (high card King)
deoxy1909 collected $3.52 from pot
*** SUMMARY ***
Total pot $3.65 | Rake $0.13 
Board [2h 7c 3s Kd 4c]
Seat 1: alphA_hAnds (button) folded before Flop
Seat 2: Ape2012 (small blind) folded before Flop
Seat 3: deoxy1909 (big blind) showed [Ad Ah] and won ($3.52) with a pair of Aces
Seat 4: aguilar_8514 folded before Flop (didn't bet)
Seat 5: UA_RUS_7891 folded before Flop (didn't bet)
Seat 6: KOSTYA STARK showed [Qs Ts] and lost with high card King



PokerStars Zoom Hand #120987257006:  Hold'em No Limit ($0.01/$0.02) - 2014/09/03 0:20:54 ET
Table 'Halley' 6-max Seat #1 is the button
Seat 1: deoxy1909 ($1.55 in chips) 
Seat 2: efegz ($3 in chips) 
Seat 3: vitalikto ($2.17 in chips) 
Seat 4: tomsutch ($2.17 in chips) 
Seat 5: isntDurrr ($1.88 in chips) 
Seat 6: fyodor917 ($2.32 in chips) 
efegz: posts small blind $0.01
vitalikto: posts big blind $0.02
*** HOLE CARDS ***
Dealt to deoxy1909 [8s 8h]
tomsutch: folds 
isntDurrr: raises $0.04 to $0.06
fyodor917: folds 
deoxy1909: calls $0.06
efegz: folds 
vitalikto: folds 
*** FLOP *** [7h Tc Jd]
isntDurrr: bets $0.07
deoxy1909: calls $0.07
*** TURN *** [7h Tc Jd] [9c]
isntDurrr: checks 
deoxy1909: bets $0.20
isntDurrr: calls $0.20
*** RIVER *** [7h Tc Jd 9c] [Kd]
isntDurrr: checks 
deoxy1909: bets $0.50
isntDurrr: calls $0.50
*** SHOW DOWN ***
deoxy1909: shows [8s 8h] (a straight, Seven to Jack)
isntDurrr: mucks hand 
deoxy1909 collected $1.63 from pot
*** SUMMARY ***
Total pot $1.69 | Rake $0.06 
Board [7h Tc Jd 9c Kd]
Seat 1: deoxy1909 (button) showed [8s 8h] and won ($1.63) with a straight, Seven to Jack
Seat 2: efegz (small blind) folded before Flop
Seat 3: vitalikto (big blind) folded before Flop
Seat 4: tomsutch folded before Flop (didn't bet)
Seat 5: isntDurrr mucked [Td Th]
Seat 6: fyodor917 folded before Flop (didn't bet)



PokerStars Zoom Hand #120987281488:  Hold'em No Limit ($0.01/$0.02) - 2014/09/03 0:22:32 ET
Table 'Halley' 6-max Seat #1 is the button
Seat 1: deoxy1909 ($2.26 in chips) 
Seat 2: Demonuga-73 ($1.90 in chips) 
Seat 3: Thant0s ($5.61 in chips) 
Seat 4: cychome ($0.94 in chips) 
Seat 5: ZuluDog ($2.25 in chips) 
Seat 6: riverflush14 ($1.85 in chips) 
Demonuga-73: posts small blind $0.01
Thant0s: posts big blind $0.02
*** HOLE CARDS ***
Dealt to deoxy1909 [Qc Ac]
cychome: folds 
ZuluDog: raises $0.04 to $0.06
riverflush14: folds 
deoxy1909: raises $0.10 to $0.16
Demonuga-73: folds 
Thant0s: calls $0.14
ZuluDog: calls $0.10
*** FLOP *** [5s 5h Th]
Thant0s: checks 
ZuluDog: checks 
deoxy1909: checks 
*** TURN *** [5s 5h Th] [Ad]
Thant0s: bets $0.16
ZuluDog: folds 
deoxy1909: calls $0.16
*** RIVER *** [5s 5h Th Ad] [Ks]
Thant0s: bets $1.42
deoxy1909: folds 
Uncalled bet ($1.42) returned to Thant0s
Thant0s collected $0.78 from pot
Thant0s: doesn't show hand 
*** SUMMARY ***
Total pot $0.81 | Rake $0.03 
Board [5s 5h Th Ad Ks]
Seat 1: deoxy1909 (button) folded on the River
Seat 2: Demonuga-73 (small blind) folded before Flop
Seat 3: Thant0s (big blind) collected ($0.78)
Seat 4: cychome folded before Flop (didn't bet)
Seat 5: ZuluDog folded on the Turn
Seat 6: riverflush14 folded before Flop (didn't bet)



PokerStars Zoom Hand #120987337985:  Hold'em No Limit ($0.01/$0.02) - 2014/09/03 0:26:19 ET
Table 'Halley' 6-max Seat #1 is the button
Seat 1: deoxy1909 ($1.90 in chips) 
Seat 2: isntDurrr ($0.95 in chips) 
Seat 3: LandroCa$h ($0.76 in chips) 
Seat 4: wwjorge ($1.73 in chips) 
Seat 5: sakippo ($2.21 in chips) 
Seat 6: TaiLung0 ($2.43 in chips) 
isntDurrr: posts small blind $0.01
LandroCa$h: posts big blind $0.02
*** HOLE CARDS ***
Dealt to deoxy1909 [2s 9c]
wwjorge has timed out
wwjorge: folds 
sakippo: folds 
TaiLung0: raises $0.04 to $0.06
deoxy1909: folds 
isntDurrr: calls $0.05
LandroCa$h: folds 
*** FLOP *** [6h 9s Jd]
isntDurrr: checks 
TaiLung0: bets $0.08
isntDurrr: calls $0.08
*** TURN *** [6h 9s Jd] [7c]
isntDurrr: checks 
TaiLung0: bets $0.20
isntDurrr: calls $0.20
*** RIVER *** [6h 9s Jd 7c] [Tc]
isntDurrr: checks 
TaiLung0: checks 
*** SHOW DOWN ***
isntDurrr: shows [Td Th] (three of a kind, Tens)
TaiLung0: mucks hand 
isntDurrr collected $0.68 from pot
*** SUMMARY ***
Total pot $0.70 | Rake $0.02 
Board [6h 9s Jd 7c Tc]
Seat 1: deoxy1909 (button) folded before Flop (didn't bet)
Seat 2: isntDurrr (small blind) showed [Td Th] and won ($0.68) with three of a kind, Tens
Seat 3: LandroCa$h (big blind) folded before Flop
Seat 4: wwjorge folded before Flop (didn't bet)
Seat 5: sakippo folded before Flop (didn't bet)
Seat 6: TaiLung0 mucked [Ah Jc]



PokerStars Zoom Hand #120987377742:  Hold'em No Limit ($0.01/$0.02) - 2014/09/03 0:28:59 ET
Table 'Halley' 6-max Seat #1 is the button
Seat 1: vozik72 ($3.55 in chips) 
Seat 2: Energetic71 ($4.34 in chips) 
Seat 3: deoxy1909 ($1.97 in chips) 
Seat 4: MrsManik ($2.09 in chips) 
Seat 5: cyanidte ($2.01 in chips) 
Seat 6: Ebarek2009 ($1.78 in chips) 
Energetic71: posts small blind $0.01
deoxy1909: posts big blind $0.02
*** HOLE CARDS ***
Dealt to deoxy1909 [4c Th]
MrsManik: calls $0.02
cyanidte: raises $0.04 to $0.06
Ebarek2009: calls $0.06
vozik72: folds 
Energetic71: folds 
deoxy1909: folds 
MrsManik: calls $0.04
*** FLOP *** [6c 3s 8s]
MrsManik: checks 
cyanidte: bets $0.20
Ebarek2009: folds 
MrsManik: raises $0.60 to $0.80
cyanidte: raises $1.15 to $1.95 and is all-in
MrsManik: calls $1.15
*** TURN *** [6c 3s 8s] [4h]
*** RIVER *** [6c 3s 8s 4h] [Ts]
*** SHOW DOWN ***
MrsManik: shows [8d Ac] (a pair of Eights)
cyanidte: shows [Qd Qc] (a pair of Queens)
cyanidte collected $3.97 from pot
*** SUMMARY ***
Total pot $4.11 | Rake $0.14 
Board [6c 3s 8s 4h Ts]
Seat 1: vozik72 (button) folded before Flop (didn't bet)
Seat 2: Energetic71 (small blind) folded before Flop
Seat 3: deoxy1909 (big blind) folded before Flop
Seat 4: MrsManik showed [8d Ac] and lost with a pair of Eights
Seat 5: cyanidte showed [Qd Qc] and won ($3.97) with a pair of Queens
Seat 6: Ebarek2009 folded on the Flop



PokerStars Zoom Hand #120987381182:  Hold'em No Limit ($0.01/$0.02) - 2014/09/03 0:29:13 ET
Table 'Halley' 6-max Seat #1 is the button
Seat 1: deoxy1909 ($1.95 in chips) 
Seat 2: Gosakh ($4.71 in chips) 
Seat 3: adiman999 ($2 in chips) 
Seat 4: javigm2 ($5.45 in chips) 
Seat 5: HmmmAA ($2 in chips) 
Seat 6: LISKENT ($2.55 in chips) 
Gosakh: posts small blind $0.01
adiman999: posts big blind $0.02
*** HOLE CARDS ***
Dealt to deoxy1909 [Jc 6c]
javigm2: raises $0.04 to $0.06
HmmmAA: folds 
LISKENT: folds 
deoxy1909: folds 
Gosakh: calls $0.05
adiman999: folds 
*** FLOP *** [6d 9h 8s]
Gosakh: checks 
javigm2: bets $0.08
Gosakh: calls $0.08
*** TURN *** [6d 9h 8s] [Kc]
Gosakh: checks 
javigm2: bets $0.20
Gosakh: calls $0.20
*** RIVER *** [6d 9h 8s Kc] [9c]
Gosakh: checks 
javigm2: checks 
*** SHOW DOWN ***
Gosakh: shows [Qd Ks] (two pair, Kings and Nines)
javigm2: mucks hand 
Gosakh collected $0.68 from pot
*** SUMMARY ***
Total pot $0.70 | Rake $0.02 
Board [6d 9h 8s Kc 9c]
Seat 1: deoxy1909 (button) folded before Flop (didn't bet)
Seat 2: Gosakh (small blind) showed [Qd Ks] and won ($0.68) with two pair, Kings and Nines
Seat 3: adiman999 (big blind) folded before Flop
Seat 4: javigm2 mucked [6s As]
Seat 5: HmmmAA folded before Flop (didn't bet)
Seat 6: LISKENT folded before Flop (didn't bet)



PokerStars Zoom Hand #120987388057:  Hold'em No Limit ($0.01/$0.02) - 2014/09/03 0:29:41 ET
Table 'Halley' 6-max Seat #1 is the button
Seat 1: sakippo ($2.27 in chips) 
Seat 2: stws31 ($2.52 in chips) 
Seat 3: deoxy1909 ($1.95 in chips) 
Seat 4: ldk9595 ($2 in chips) 
Seat 5: 2b3ftw ($2.16 in chips) 
Seat 6: Grieverghast ($2.01 in chips) 
stws31: posts small blind $0.01
deoxy1909: posts big blind $0.02
*** HOLE CARDS ***
Dealt to deoxy1909 [5h 3s]
ldk9595: folds 
2b3ftw: raises $0.04 to $0.06
Grieverghast: folds 
sakippo: folds 
stws31: raises $0.12 to $0.18
deoxy1909: folds 
2b3ftw: raises $0.28 to $0.46
stws31: raises $1.04 to $1.50
2b3ftw: folds 
Uncalled bet ($1.04) returned to stws31
stws31 collected $0.94 from pot
stws31: doesn't show hand 
*** SUMMARY ***
Total pot $0.94 | Rake $0 
Seat 1: sakippo (button) folded before Flop (didn't bet)
Seat 2: stws31 (small blind) collected ($0.94)
Seat 3: deoxy1909 (big blind) folded before Flop
Seat 4: ldk9595 folded before Flop (didn't bet)
Seat 5: 2b3ftw folded before Flop
Seat 6: Grieverghast folded before Flop (didn't bet)



PokerStars Zoom Hand #120987425848:  Hold'em No Limit ($0.01/$0.02) - 2014/09/03 0:32:11 ET
Table 'Halley' 6-max Seat #1 is the button
Seat 1: Sleviin8 ($3.14 in chips) 
Seat 2: vozik72 ($5.10 in chips) 
Seat 3: Kirya2790 ($2.12 in chips) 
Seat 4: TaiLung0 ($4.90 in chips) 
Seat 5: deoxy1909 ($1.86 in chips) 
Seat 6: The Goose LA ($2.10 in chips) 
vozik72: posts small blind $0.01
Kirya2790: posts big blind $0.02
*** HOLE CARDS ***
Dealt to deoxy1909 [Tc Ad]
TaiLung0: folds 
deoxy1909: raises $0.04 to $0.06
The Goose LA: calls $0.06
Sleviin8: folds 
vozik72: calls $0.05
Kirya2790: folds 
*** FLOP *** [4h 9h Qc]
vozik72: checks 
deoxy1909: checks 
The Goose LA: checks 
*** TURN *** [4h 9h Qc] [Td]
vozik72: checks 
deoxy1909: bets $0.12
The Goose LA: raises $0.43 to $0.55
vozik72: folds 
deoxy1909: calls $0.43
*** RIVER *** [4h 9h Qc Td] [9c]
deoxy1909: bets $1.25 and is all-in
The Goose LA: calls $1.25
*** SHOW DOWN ***
deoxy1909: shows [Tc Ad] (two pair, Tens and Nines)
The Goose LA: shows [Kh Js] (a straight, Nine to King)
The Goose LA collected $3.67 from pot
*** SUMMARY ***
Total pot $3.80 | Rake $0.13 
Board [4h 9h Qc Td 9c]
Seat 1: Sleviin8 (button) folded before Flop (didn't bet)
Seat 2: vozik72 (small blind) folded on the Turn
Seat 3: Kirya2790 (big blind) folded before Flop
Seat 4: TaiLung0 folded before Flop (didn't bet)
Seat 5: deoxy1909 showed [Tc Ad] and lost with two pair, Tens and Nines
Seat 6: The Goose LA showed [Kh Js] and won ($3.67) with a straight, Nine to King



PokerStars Zoom Hand #120987462590:  Hold'em No Limit ($0.01/$0.02) - 2014/09/03 0:34:41 ET
Table 'Halley' 6-max Seat #1 is the button
Seat 1: TaiLung0 ($4.23 in chips) 
Seat 2: deoxy1909 ($0.89 in chips) 
Seat 3: LMDESTRO ($2.40 in chips) 
Seat 4: goldingA&SS ($0.74 in chips) 
Seat 5: canesas ($1.92 in chips) 
Seat 6: alonsoburga ($0.21 in chips) 
deoxy1909: posts small blind $0.01
LMDESTRO: posts big blind $0.02
*** HOLE CARDS ***
Dealt to deoxy1909 [5s Qs]
goldingA&SS: raises $0.04 to $0.06
canesas: calls $0.06
alonsoburga: folds 
TaiLung0: folds 
deoxy1909: folds 
LMDESTRO: calls $0.04
*** FLOP *** [2d 4h 6h]
LMDESTRO: bets $0.08
goldingA&SS: raises $0.08 to $0.16
canesas: folds 
LMDESTRO: calls $0.08
*** TURN *** [2d 4h 6h] [Qd]
LMDESTRO: checks 
goldingA&SS: bets $0.24
LMDESTRO: folds 
Uncalled bet ($0.24) returned to goldingA&SS
goldingA&SS collected $0.49 from pot
goldingA&SS: doesn't show hand 
*** SUMMARY ***
Total pot $0.51 | Rake $0.02 
Board [2d 4h 6h Qd]
Seat 1: TaiLung0 (button) folded before Flop (didn't bet)
Seat 2: deoxy1909 (small blind) folded before Flop
Seat 3: LMDESTRO (big blind) folded on the Turn
Seat 4: goldingA&SS collected ($0.49)
Seat 5: canesas folded on the Flop
Seat 6: alonsoburga folded before Flop (didn't bet)



PokerStars Zoom Hand #120991035783:  Hold'em No Limit ($0.01/$0.02) - 2014/09/03 4:28:23 ET
Table 'Halley' 6-max Seat #1 is the button
Seat 1: Pdvk ($2 in chips) 
Seat 2: Gerabella54 ($5.42 in chips) 
Seat 3: deoxy1909 ($1.29 in chips) 
Seat 4: soyelpa ($2.92 in chips) 
Seat 5: ferret1958 ($2.22 in chips) 
Seat 6: one piiece ($2.38 in chips) 
Gerabella54: posts small blind $0.01
deoxy1909: posts big blind $0.02
*** HOLE CARDS ***
Dealt to deoxy1909 [As Ad]
soyelpa: raises $0.23 to $0.25
ferret1958: folds 
one piiece: folds 
Pdvk: folds 
Gerabella54: folds 
deoxy1909: raises $0.51 to $0.76
soyelpa: raises $2.16 to $2.92 and is all-in
deoxy1909: calls $0.53 and is all-in
Uncalled bet ($1.63) returned to soyelpa
*** FLOP *** [Td 7d 3s]
*** TURN *** [Td 7d 3s] [5d]
*** RIVER *** [Td 7d 3s 5d] [5h]
*** SHOW DOWN ***
deoxy1909: shows [As Ad] (two pair, Aces and Fives)
soyelpa: shows [Ac Qs] (a pair of Fives)
deoxy1909 collected $2.50 from pot
*** SUMMARY ***
Total pot $2.59 | Rake $0.09 
Board [Td 7d 3s 5d 5h]
Seat 1: Pdvk (button) folded before Flop (didn't bet)
Seat 2: Gerabella54 (small blind) folded before Flop
Seat 3: deoxy1909 (big blind) showed [As Ad] and won ($2.50) with two pair, Aces and Fives
Seat 4: soyelpa showed [Ac Qs] and lost with a pair of Fives
Seat 5: ferret1958 folded before Flop (didn't bet)
Seat 6: one piiece folded before Flop (didn't bet)



PokerStars Zoom Hand #120991054178:  Hold'em No Limit ($0.01/$0.02) - 2014/09/03 4:29:18 ET
Table 'Halley' 6-max Seat #1 is the button
Seat 1: melzer sp. ($3.39 in chips) 
Seat 2: Velxer ($0.94 in chips) 
Seat 3: deoxy1909 ($2.49 in chips) 
Seat 4: achiteid ($2.40 in chips) 
Seat 5: rubint18 ($2.77 in chips) 
Seat 6: MaloyAndSo ($3.87 in chips) 
Velxer: posts small blind $0.01
deoxy1909: posts big blind $0.02
*** HOLE CARDS ***
Dealt to deoxy1909 [Qd Qs]
achiteid: folds 
rubint18: folds 
MaloyAndSo: raises $0.04 to $0.06
melzer sp.: folds 
Velxer: calls $0.05
deoxy1909: raises $0.14 to $0.20
MaloyAndSo: folds 
Velxer: calls $0.14
*** FLOP *** [As 9d Ks]
Velxer: checks 
deoxy1909: bets $0.32
Velxer: raises $0.42 to $0.74 and is all-in
deoxy1909: folds 
Uncalled bet ($0.42) returned to Velxer
Velxer collected $1.06 from pot
Velxer: doesn't show hand 
*** SUMMARY ***
Total pot $1.10 | Rake $0.04 
Board [As 9d Ks]
Seat 1: melzer sp. (button) folded before Flop (didn't bet)
Seat 2: Velxer (small blind) collected ($1.06)
Seat 3: deoxy1909 (big blind) folded on the Flop
Seat 4: achiteid folded before Flop (didn't bet)
Seat 5: rubint18 folded before Flop (didn't bet)
Seat 6: MaloyAndSo folded before Flop



PokerStars Zoom Hand #120991082429:  Hold'em No Limit ($0.01/$0.02) - 2014/09/03 4:30:42 ET
Table 'Halley' 6-max Seat #1 is the button
Seat 1: deoxy1909 ($1.93 in chips) 
Seat 2: chrisoik ($2 in chips) 
Seat 3: prepisor ($2.12 in chips) 
Seat 4: homeronriver ($2.08 in chips) 
Seat 5: emo114 ($2.17 in chips) 
Seat 6: zoombamboom ($2.97 in chips) 
chrisoik: posts small blind $0.01
prepisor: posts big blind $0.02
*** HOLE CARDS ***
Dealt to deoxy1909 [Ks 2d]
homeronriver: raises $0.04 to $0.06
emo114: folds 
zoombamboom: folds 
deoxy1909: folds 
chrisoik: calls $0.05
prepisor: calls $0.04
*** FLOP *** [Th 3h Jh]
chrisoik: checks 
prepisor: checks 
homeronriver: bets $0.12
chrisoik: calls $0.12
prepisor: folds 
*** TURN *** [Th 3h Jh] [7s]
chrisoik: checks 
homeronriver: bets $0.30
chrisoik: calls $0.30
*** RIVER *** [Th 3h Jh 7s] [4c]
chrisoik: checks 
homeronriver: checks 
*** SHOW DOWN ***
chrisoik: shows [Jc Qs] (a pair of Jacks)
homeronriver: shows [Js Ts] (two pair, Jacks and Tens)
homeronriver collected $0.98 from pot
*** SUMMARY ***
Total pot $1.02 | Rake $0.04 
Board [Th 3h Jh 7s 4c]
Seat 1: deoxy1909 (button) folded before Flop (didn't bet)
Seat 2: chrisoik (small blind) showed [Jc Qs] and lost with a pair of Jacks
Seat 3: prepisor (big blind) folded on the Flop
Seat 4: homeronriver showed [Js Ts] and won ($0.98) with two pair, Jacks and Tens
Seat 5: emo114 folded before Flop (didn't bet)
Seat 6: zoombamboom folded before Flop (didn't bet)



PokerStars Zoom Hand #120991174329:  Hold'em No Limit ($0.01/$0.02) - 2014/09/03 4:35:11 ET
Table 'Halley' 6-max Seat #1 is the button
Seat 1: deoxy1909 ($1.91 in chips) 
Seat 2: sZRAMEK ($2.35 in chips) 
Seat 3: Unfreguented ($3.71 in chips) 
Seat 4: Anastassiya3 ($8.33 in chips) 
Seat 5: sergiy6304 ($6.04 in chips) 
Seat 6: betamin85 ($1.06 in chips) 
sZRAMEK: posts small blind $0.01
Unfreguented: posts big blind $0.02
*** HOLE CARDS ***
Dealt to deoxy1909 [Qc 7s]
Anastassiya3: raises $0.04 to $0.06
sergiy6304: folds 
betamin85: folds 
deoxy1909: folds 
sZRAMEK: calls $0.05
Unfreguented: folds 
*** FLOP *** [6c 4d 7d]
sZRAMEK: checks 
Anastassiya3: bets $0.10
sZRAMEK: raises $0.10 to $0.20
Anastassiya3: calls $0.10
*** TURN *** [6c 4d 7d] [4s]
sZRAMEK: bets $0.26
Anastassiya3: calls $0.26
*** RIVER *** [6c 4d 7d 4s] [Js]
sZRAMEK: bets $0.51
Anastassiya3: raises $7.30 to $7.81 and is all-in
sZRAMEK: folds 
Uncalled bet ($7.30) returned to Anastassiya3
Anastassiya3 collected $2.01 from pot
Anastassiya3: doesn't show hand 
*** SUMMARY ***
Total pot $2.08 | Rake $0.07 
Board [6c 4d 7d 4s Js]
Seat 1: deoxy1909 (button) folded before Flop (didn't bet)
Seat 2: sZRAMEK (small blind) folded on the River
Seat 3: Unfreguented (big blind) folded before Flop
Seat 4: Anastassiya3 collected ($2.01)
Seat 5: sergiy6304 folded before Flop (didn't bet)
Seat 6: betamin85 folded before Flop (didn't bet)



PokerStars Zoom Hand #120991217196:  Hold'em No Limit ($0.01/$0.02) - 2014/09/03 4:37:15 ET
Table 'Halley' 6-max Seat #1 is the button
Seat 1: RCDC2312 ($2.25 in chips) 
Seat 2: deoxy1909 ($1.92 in chips) 
Seat 3: vitalikto ($5.81 in chips) 
Seat 4: kenshinzdh ($1.97 in chips) 
Seat 5: pataletik ($3.82 in chips) 
Seat 6: Anastassiya3 ($8.34 in chips) 
deoxy1909: posts small blind $0.01
vitalikto: posts big blind $0.02
*** HOLE CARDS ***
Dealt to deoxy1909 [As Jh]
kenshinzdh: folds 
pataletik: folds 
Anastassiya3: raises $0.04 to $0.06
RCDC2312: folds 
deoxy1909: calls $0.05
vitalikto: calls $0.04
*** FLOP *** [9c 6d 7d]
deoxy1909: checks 
vitalikto: checks 
Anastassiya3: checks 
*** TURN *** [9c 6d 7d] [Ac]
deoxy1909: bets $0.12
vitalikto: raises $0.20 to $0.32
Anastassiya3: folds 
deoxy1909: calls $0.20
*** RIVER *** [9c 6d 7d Ac] [Jd]
deoxy1909: checks 
vitalikto: checks 
*** SHOW DOWN ***
deoxy1909: shows [As Jh] (two pair, Aces and Jacks)
vitalikto: shows [9s 9d] (three of a kind, Nines)
vitalikto collected $0.79 from pot
*** SUMMARY ***
Total pot $0.82 | Rake $0.03 
Board [9c 6d 7d Ac Jd]
Seat 1: RCDC2312 (button) folded before Flop (didn't bet)
Seat 2: deoxy1909 (small blind) showed [As Jh] and lost with two pair, Aces and Jacks
Seat 3: vitalikto (big blind) showed [9s 9d] and won ($0.79) with three of a kind, Nines
Seat 4: kenshinzdh folded before Flop (didn't bet)
Seat 5: pataletik folded before Flop (didn't bet)
Seat 6: Anastassiya3 folded on the Turn



PokerStars Zoom Hand #120991301407:  Hold'em No Limit ($0.01/$0.02) - 2014/09/03 4:41:19 ET
Table 'Halley' 6-max Seat #1 is the button
Seat 1: deoxy1909 ($1.50 in chips) 
Seat 2: Primozb ($5.36 in chips) 
Seat 3: tsoyskiy1 ($2.21 in chips) 
Seat 4: ChrisPobs ($2.09 in chips) 
Seat 5: savagelow7 ($3.74 in chips) 
Seat 6: Ferris188 ($2.38 in chips) 
Primozb: posts small blind $0.01
tsoyskiy1: posts big blind $0.02
*** HOLE CARDS ***
Dealt to deoxy1909 [Jh 6d]
ChrisPobs: raises $0.05 to $0.07
savagelow7: folds 
Ferris188: raises $0.09 to $0.16
deoxy1909: folds 
Primozb: folds 
tsoyskiy1: calls $0.14
ChrisPobs: raises $0.42 to $0.58
Ferris188: folds 
tsoyskiy1: calls $0.42
*** FLOP *** [Jc 8c As]
tsoyskiy1: bets $1.63 and is all-in
ChrisPobs: folds 
Uncalled bet ($1.63) returned to tsoyskiy1
tsoyskiy1 collected $1.28 from pot
tsoyskiy1: doesn't show hand 
*** SUMMARY ***
Total pot $1.33 | Rake $0.05 
Board [Jc 8c As]
Seat 1: deoxy1909 (button) folded before Flop (didn't bet)
Seat 2: Primozb (small blind) folded before Flop
Seat 3: tsoyskiy1 (big blind) collected ($1.28)
Seat 4: ChrisPobs folded on the Flop
Seat 5: savagelow7 folded before Flop (didn't bet)
Seat 6: Ferris188 folded before Flop



PokerStars Zoom Hand #120991307937:  Hold'em No Limit ($0.01/$0.02) - 2014/09/03 4:41:38 ET
Table 'Halley' 6-max Seat #1 is the button
Seat 1: Masa kissed ($5.68 in chips) 
Seat 2: deoxy1909 ($1.50 in chips) 
Seat 3: judii1111 ($2 in chips) 
Seat 4: charos17 ($3.11 in chips) 
Seat 5: TRIOOMF ($1.18 in chips) 
Seat 6: Kryptorianec ($2 in chips) 
deoxy1909: posts small blind $0.01
judii1111: posts big blind $0.02
*** HOLE CARDS ***
Dealt to deoxy1909 [Js 2s]
charos17: folds 
TRIOOMF: folds 
Kryptorianec: folds 
Masa kissed: raises $0.04 to $0.06
deoxy1909: folds 
judii1111: calls $0.04
*** FLOP *** [Th 6h Ac]
judii1111: checks 
Masa kissed: bets $0.08
judii1111: raises $0.08 to $0.16
Masa kissed: calls $0.08
*** TURN *** [Th 6h Ac] [2d]
judii1111: bets $0.21
Masa kissed: calls $0.21
*** RIVER *** [Th 6h Ac 2d] [Kc]
judii1111: checks 
Masa kissed: checks 
*** SHOW DOWN ***
judii1111: shows [7c Ad] (a pair of Aces)
Masa kissed: mucks hand 
judii1111 collected $0.84 from pot
*** SUMMARY ***
Total pot $0.87 | Rake $0.03 
Board [Th 6h Ac 2d Kc]
Seat 1: Masa kissed (button) mucked [8d 8s]
Seat 2: deoxy1909 (small blind) folded before Flop
Seat 3: judii1111 (big blind) showed [7c Ad] and won ($0.84) with a pair of Aces
Seat 4: charos17 folded before Flop (didn't bet)
Seat 5: TRIOOMF folded before Flop (didn't bet)
Seat 6: Kryptorianec folded before Flop (didn't bet)



PokerStars Zoom Hand #120991332342:  Hold'em No Limit ($0.01/$0.02) - 2014/09/03 4:42:46 ET
Table 'Halley' 6-max Seat #1 is the button
Seat 1: TRIOOMF ($1.33 in chips) 
Seat 2: deoxy1909 ($1.50 in chips) 
Seat 3: Baltazar142 ($0.90 in chips) 
Seat 4: wkulig ($4.37 in chips) 
Seat 5: dieying ($1.86 in chips) 
Seat 6: bakbakyv777 ($4.05 in chips) 
deoxy1909: posts small blind $0.01
Baltazar142: posts big blind $0.02
*** HOLE CARDS ***
Dealt to deoxy1909 [8d 6s]
wkulig: folds 
dieying: folds 
bakbakyv777: raises $0.05 to $0.07
TRIOOMF: folds 
deoxy1909: folds 
Baltazar142: calls $0.05
*** FLOP *** [As 5d 7h]
Baltazar142: checks 
bakbakyv777: bets $0.07
Baltazar142: calls $0.07
*** TURN *** [As 5d 7h] [5c]
Baltazar142: checks 
bakbakyv777: bets $0.14
Baltazar142: raises $0.14 to $0.28
bakbakyv777: calls $0.14
*** RIVER *** [As 5d 7h 5c] [2d]
Baltazar142: bets $0.41
Baltazar142 said, "A"
bakbakyv777: folds 
Uncalled bet ($0.41) returned to Baltazar142
Baltazar142 collected $0.82 from pot
Baltazar142: doesn't show hand 
*** SUMMARY ***
Total pot $0.85 | Rake $0.03 
Board [As 5d 7h 5c 2d]
Seat 1: TRIOOMF (button) folded before Flop (didn't bet)
Seat 2: deoxy1909 (small blind) folded before Flop
Seat 3: Baltazar142 (big blind) collected ($0.82)
Seat 4: wkulig folded before Flop (didn't bet)
Seat 5: dieying folded before Flop (didn't bet)
Seat 6: bakbakyv777 folded on the River



PokerStars Zoom Hand #120991486993:  Hold'em No Limit ($0.01/$0.02) - 2014/09/03 4:49:55 ET
Table 'Halley' 6-max Seat #1 is the button
Seat 1: deoxy1909 ($1.48 in chips) 
Seat 2: nikkem971 ($1.98 in chips) 
Seat 3: darcagegns ($3.86 in chips) 
Seat 4: Isafold1 ($1.92 in chips) 
Seat 5: bikedevil996 ($3.80 in chips) 
Seat 6: 2Aces220186 ($2 in chips) 
nikkem971: posts small blind $0.01
darcagegns: posts big blind $0.02
*** HOLE CARDS ***
Dealt to deoxy1909 [6c Qc]
Isafold1: folds 
bikedevil996: folds 
2Aces220186: raises $0.04 to $0.06
deoxy1909: folds 
nikkem971: calls $0.05
darcagegns: folds 
*** FLOP *** [Jc Jd 3h]
nikkem971: checks 
2Aces220186: bets $0.06
nikkem971: calls $0.06
*** TURN *** [Jc Jd 3h] [Ac]
nikkem971: checks 
2Aces220186: checks 
*** RIVER *** [Jc Jd 3h Ac] [2s]
nikkem971: bets $0.20
2Aces220186: calls $0.20
*** SHOW DOWN ***
nikkem971: shows [Ad Js] (a full house, Jacks full of Aces)
2Aces220186: mucks hand 
nikkem971 collected $0.64 from pot
*** SUMMARY ***
Total pot $0.66 | Rake $0.02 
Board [Jc Jd 3h Ac 2s]
Seat 1: deoxy1909 (button) folded before Flop (didn't bet)
Seat 2: nikkem971 (small blind) showed [Ad Js] and won ($0.64) with a full house, Jacks full of Aces
Seat 3: darcagegns (big blind) folded before Flop
Seat 4: Isafold1 folded before Flop (didn't bet)
Seat 5: bikedevil996 folded before Flop (didn't bet)
Seat 6: 2Aces220186 mucked [Tc Td]



PokerStars Zoom Hand #120991588275:  Hold'em No Limit ($0.01/$0.02) - 2014/09/03 4:54:37 ET
Table 'Halley' 6-max Seat #1 is the button
Seat 1: DavidMKS ($4.44 in chips) 
Seat 2: sZRAMEK ($2.88 in chips) 
Seat 3: deoxy1909 ($1.17 in chips) 
Seat 4: Umka040385 ($3.62 in chips) 
Seat 5: scoReRy ($2.10 in chips) 
Seat 6: gifmijorkesz ($4.55 in chips) 
sZRAMEK: posts small blind $0.01
deoxy1909: posts big blind $0.02
*** HOLE CARDS ***
Dealt to deoxy1909 [6d 4s]
Umka040385: folds 
scoReRy: folds 
gifmijorkesz: raises $0.04 to $0.06
DavidMKS: calls $0.06
sZRAMEK: folds 
deoxy1909: folds 
*** FLOP *** [4h Th 3h]
gifmijorkesz: bets $0.10
DavidMKS: calls $0.10
*** TURN *** [4h Th 3h] [Ks]
gifmijorkesz: bets $0.25
DavidMKS: calls $0.25
*** RIVER *** [4h Th 3h Ks] [Js]
gifmijorkesz: bets $0.41
DavidMKS: calls $0.41
*** SHOW DOWN ***
gifmijorkesz: shows [8h 9h] (a flush, Ten high)
DavidMKS: mucks hand 
gifmijorkesz collected $1.61 from pot
*** SUMMARY ***
Total pot $1.67 | Rake $0.06 
Board [4h Th 3h Ks Js]
Seat 1: DavidMKS (button) mucked [Kc Ad]
Seat 2: sZRAMEK (small blind) folded before Flop
Seat 3: deoxy1909 (big blind) folded before Flop
Seat 4: Umka040385 folded before Flop (didn't bet)
Seat 5: scoReRy folded before Flop (didn't bet)
Seat 6: gifmijorkesz showed [8h 9h] and won ($1.61) with a flush, Ten high



PokerStars Zoom Hand #120991619097:  Hold'em No Limit ($0.01/$0.02) - 2014/09/03 4:56:13 ET
Table 'Halley' 6-max Seat #1 is the button
Seat 1: Gerabella54 ($3.38 in chips) 
Seat 2: deoxy1909 ($1.18 in chips) 
Seat 3: ChrisPobs ($3.48 in chips) 
Seat 4: sagrata 12 ($2.32 in chips) 
Seat 5: innacente ($5.92 in chips) 
Seat 6: 1a2a3a0p9p ($2.59 in chips) 
deoxy1909: posts small blind $0.01
ChrisPobs: posts big blind $0.02
*** HOLE CARDS ***
Dealt to deoxy1909 [9c 8c]
sagrata 12: raises $0.05 to $0.07
innacente: folds 
1a2a3a0p9p: calls $0.07
Gerabella54: calls $0.07
deoxy1909: folds 
ChrisPobs: calls $0.05
*** FLOP *** [Qh 8h Ah]
ChrisPobs: checks 
sagrata 12: bets $0.14
1a2a3a0p9p: folds 
Gerabella54: calls $0.14
ChrisPobs: folds 
*** TURN *** [Qh 8h Ah] [Ts]
sagrata 12: bets $0.27
Gerabella54: calls $0.27
*** RIVER *** [Qh 8h Ah Ts] [6s]
sagrata 12: bets $0.53
Gerabella54: calls $0.53
*** SHOW DOWN ***
sagrata 12: shows [Qs As] (two pair, Aces and Queens)
Gerabella54: shows [Td Th] (three of a kind, Tens)
Gerabella54 collected $2.09 from pot
*** SUMMARY ***
Total pot $2.17 | Rake $0.08 
Board [Qh 8h Ah Ts 6s]
Seat 1: Gerabella54 (button) showed [Td Th] and won ($2.09) with three of a kind, Tens
Seat 2: deoxy1909 (small blind) folded before Flop
Seat 3: ChrisPobs (big blind) folded on the Flop
Seat 4: sagrata 12 showed [Qs As] and lost with two pair, Aces and Queens
Seat 5: innacente folded before Flop (didn't bet)
Seat 6: 1a2a3a0p9p folded on the Flop



PokerStars Zoom Hand #120991687721:  Hold'em No Limit ($0.01/$0.02) - 2014/09/03 5:00:00 ET
Table 'Halley' 6-max Seat #1 is the button
Seat 1: deoxy1909 ($1.14 in chips) 
Seat 2: Dengken ($2.61 in chips) 
Seat 3: Adlerro ($2.17 in chips) 
Seat 4: Liptonik844 ($2.88 in chips) 
Seat 5: gorbachofff2 ($1.08 in chips) 
Seat 6: PokerProffi1 ($8.24 in chips) 
Dengken: posts small blind $0.01
Adlerro: posts big blind $0.02
*** HOLE CARDS ***
Dealt to deoxy1909 [3h 8h]
Liptonik844: raises $0.04 to $0.06
gorbachofff2: folds 
PokerProffi1: calls $0.06
deoxy1909: folds 
Dengken: folds 
Adlerro: folds 
*** FLOP *** [5h 2h Tc]
Liptonik844: bets $0.09
PokerProffi1: raises $0.10 to $0.19
Liptonik844: calls $0.10
*** TURN *** [5h 2h Tc] [6h]
Liptonik844: checks 
PokerProffi1: checks 
*** RIVER *** [5h 2h Tc 6h] [6c]
Liptonik844: bets $0.51
PokerProffi1: folds 
Uncalled bet ($0.51) returned to Liptonik844
Liptonik844 collected $0.51 from pot
Liptonik844: doesn't show hand 
*** SUMMARY ***
Total pot $0.53 | Rake $0.02 
Board [5h 2h Tc 6h 6c]
Seat 1: deoxy1909 (button) folded before Flop (didn't bet)
Seat 2: Dengken (small blind) folded before Flop
Seat 3: Adlerro (big blind) folded before Flop
Seat 4: Liptonik844 collected ($0.51)
Seat 5: gorbachofff2 folded before Flop (didn't bet)
Seat 6: PokerProffi1 folded on the River



PokerStars Zoom Hand #120991683991:  Hold'em No Limit ($0.01/$0.02) - 2014/09/03 4:59:48 ET
Table 'Halley' 6-max Seat #1 is the button
Seat 1: metin1999 ($1.12 in chips) 
Seat 2: deoxy1909 ($1.15 in chips) 
Seat 3: one piiece ($4.94 in chips) 
Seat 4: papaduck33 ($3.83 in chips) 
Seat 5: 77ACHAT 77 ($2.13 in chips) 
Seat 6: 1captain83 ($4.34 in chips) 
deoxy1909: posts small blind $0.01
one piiece: posts big blind $0.02
*** HOLE CARDS ***
Dealt to deoxy1909 [Th 2c]
papaduck33: folds 
77ACHAT 77: calls $0.02
1captain83: raises $0.06 to $0.08
metin1999: calls $0.08
deoxy1909: folds 
one piiece: folds 
77ACHAT 77: calls $0.06
*** FLOP *** [2s 9d 8s]
77ACHAT 77: checks 
1captain83: bets $0.18
metin1999: calls $0.18
77ACHAT 77: calls $0.18
*** TURN *** [2s 9d 8s] [5d]
77ACHAT 77: checks 
1captain83: checks 
metin1999: checks 
*** RIVER *** [2s 9d 8s 5d] [5c]
77ACHAT 77: bets $0.39
1captain83: folds 
metin1999: folds 
Uncalled bet ($0.39) returned to 77ACHAT 77
77ACHAT 77 collected $0.78 from pot
77ACHAT 77: doesn't show hand 
*** SUMMARY ***
Total pot $0.81 | Rake $0.03 
Board [2s 9d 8s 5d 5c]
Seat 1: metin1999 (button) folded on the River
Seat 2: deoxy1909 (small blind) folded before Flop
Seat 3: one piiece (big blind) folded before Flop
Seat 4: papaduck33 folded before Flop (didn't bet)
Seat 5: 77ACHAT 77 collected ($0.78)
Seat 6: 1captain83 folded on the River



PokerStars Zoom Hand #120991724225:  Hold'em No Limit ($0.01/$0.02) - 2014/09/03 5:01:45 ET
Table 'Halley' 6-max Seat #1 is the button
Seat 1: deoxy1909 ($1.10 in chips) 
Seat 2: dr4cO ($2.08 in chips) 
Seat 3: skendroshen ($2 in chips) 
Seat 4: dampovip ($2.07 in chips) 
Seat 5: Dengken ($2 in chips) 
Seat 6: necro0811 ($3.51 in chips) 
dr4cO: posts small blind $0.01
skendroshen: posts big blind $0.02
*** HOLE CARDS ***
Dealt to deoxy1909 [Jh 4h]
dampovip: folds 
Dengken: raises $0.04 to $0.06
necro0811: calls $0.06
deoxy1909: folds 
dr4cO: folds 
skendroshen: folds 
*** FLOP *** [6c 8c 2s]
Dengken: bets $0.07
necro0811: calls $0.07
*** TURN *** [6c 8c 2s] [7s]
Dengken: bets $0.14
necro0811: calls $0.14
*** RIVER *** [6c 8c 2s 7s] [Ts]
Dengken: bets $0.27
necro0811: calls $0.27
*** SHOW DOWN ***
Dengken: shows [6h 6d] (three of a kind, Sixes)
necro0811: mucks hand 
Dengken collected $1.07 from pot
*** SUMMARY ***
Total pot $1.11 | Rake $0.04 
Board [6c 8c 2s 7s Ts]
Seat 1: deoxy1909 (button) folded before Flop (didn't bet)
Seat 2: dr4cO (small blind) folded before Flop
Seat 3: skendroshen (big blind) folded before Flop
Seat 4: dampovip folded before Flop (didn't bet)
Seat 5: Dengken showed [6h 6d] and won ($1.07) with three of a kind, Sixes
Seat 6: necro0811 mucked [Kc Ad]



PokerStars Zoom Hand #120991742343:  Hold'em No Limit ($0.01/$0.02) - 2014/09/03 5:02:34 ET
Table 'Halley' 6-max Seat #1 is the button
Seat 1: kotbalamut ($2.89 in chips) 
Seat 2: VaNkaTa!112 ($4.14 in chips) 
Seat 3: deoxy1909 ($1.10 in chips) 
Seat 4: Jakucevicius ($3.73 in chips) 
Seat 5: Nico_Blue73 ($0.31 in chips) 
Seat 6: wkulig ($3.03 in chips) 
VaNkaTa!112: posts small blind $0.01
deoxy1909: posts big blind $0.02
*** HOLE CARDS ***
Dealt to deoxy1909 [7d Ah]
Jakucevicius: raises $0.06 to $0.08
Nico_Blue73: raises $0.23 to $0.31 and is all-in
wkulig: folds 
kotbalamut: folds 
VaNkaTa!112: folds 
deoxy1909: folds 
Jakucevicius: calls $0.23
*** FIRST FLOP *** [9c 8s 5c]
*** FIRST TURN *** [9c 8s 5c] [2s]
*** FIRST RIVER *** [9c 8s 5c 2s] [3c]
*** SECOND FLOP *** [Tc 9h 7c]
*** SECOND TURN *** [Tc 9h 7c] [Ks]
*** SECOND RIVER *** [Tc 9h 7c Ks] [8h]
*** FIRST SHOW DOWN ***
Jakucevicius: shows [6s 6d] (a pair of Sixes)
Nico_Blue73: shows [As 9s] (a pair of Nines)
Nico_Blue73 collected $0.32 from pot
*** SECOND SHOW DOWN ***
Jakucevicius: shows [6s 6d] (a straight, Six to Ten)
Nico_Blue73: shows [As 9s] (a pair of Nines)
Jakucevicius collected $0.31 from pot
*** SUMMARY ***
Total pot $0.65 | Rake $0.02 
Hand was run twice
FIRST Board [9c 8s 5c 2s 3c]
SECOND Board [Tc 9h 7c Ks 8h]
Seat 1: kotbalamut (button) folded before Flop (didn't bet)
Seat 2: VaNkaTa!112 (small blind) folded before Flop
Seat 3: deoxy1909 (big blind) folded before Flop
Seat 4: Jakucevicius showed [6s 6d] and lost with a pair of Sixes, and won ($0.31) with a straight, Six to Ten
Seat 5: Nico_Blue73 showed [As 9s] and won ($0.32) with a pair of Nines, and lost with a pair of Nines
Seat 6: wkulig folded before Flop (didn't bet)



PokerStars Zoom Hand #120991759310:  Hold'em No Limit ($0.01/$0.02) - 2014/09/03 5:03:20 ET
Table 'Halley' 6-max Seat #1 is the button
Seat 1: krckamopomal ($1.94 in chips) 
Seat 2: jenua96 ($1.67 in chips) 
Seat 3: deoxy1909 ($1.16 in chips) 
Seat 4: wkulig ($4.24 in chips) 
Seat 5: longhair180 ($3.97 in chips) 
Seat 6: triumphat ($2.14 in chips) 
jenua96: posts small blind $0.01
deoxy1909: posts big blind $0.02
*** HOLE CARDS ***
Dealt to deoxy1909 [As 2c]
wkulig: folds 
longhair180: raises $0.04 to $0.06
triumphat: folds 
krckamopomal has timed out
krckamopomal: folds 
jenua96: calls $0.05
deoxy1909: folds 
*** FLOP *** [9s Ts 5d]
jenua96: bets $0.04
longhair180: raises $0.08 to $0.12
jenua96: calls $0.08
*** TURN *** [9s Ts 5d] [Ks]
jenua96: bets $0.04
longhair180: calls $0.04
*** RIVER *** [9s Ts 5d Ks] [7s]
jenua96: bets $0.08
longhair180: calls $0.08
*** SHOW DOWN ***
jenua96: shows [Qh Jd] (a straight, Nine to King)
longhair180: mucks hand 
jenua96 collected $0.60 from pot
*** SUMMARY ***
Total pot $0.62 | Rake $0.02 
Board [9s Ts 5d Ks 7s]
Seat 1: krckamopomal (button) folded before Flop (didn't bet)
Seat 2: jenua96 (small blind) showed [Qh Jd] and won ($0.60) with a straight, Nine to King
Seat 3: deoxy1909 (big blind) folded before Flop
Seat 4: wkulig folded before Flop (didn't bet)
Seat 5: longhair180 mucked [9h 9d]
Seat 6: triumphat folded before Flop (didn't bet)



PokerStars Zoom Hand #120991775259:  Hold'em No Limit ($0.01/$0.02) - 2014/09/03 5:04:01 ET
Table 'Halley' 6-max Seat #1 is the button
Seat 1: bakugn ($2.23 in chips) 
Seat 2: deoxy1909 ($1.14 in chips) 
Seat 3: wkulig ($4.21 in chips) 
Seat 4: innacente ($6.63 in chips) 
Seat 5: VaDilin ($0.94 in chips) 
Seat 6: marcel046 ($2.13 in chips) 
deoxy1909: posts small blind $0.01
wkulig: posts big blind $0.02
*** HOLE CARDS ***
Dealt to deoxy1909 [8d 8s]
innacente: folds 
VaDilin: raises $0.04 to $0.06
marcel046: folds 
bakugn: folds 
deoxy1909: calls $0.05
wkulig: folds 
*** FLOP *** [6c 5d Jh]
deoxy1909: bets $0.08
VaDilin: raises $0.16 to $0.24
deoxy1909: calls $0.16
*** TURN *** [6c 5d Jh] [3s]
deoxy1909: checks 
VaDilin: bets $0.38
deoxy1909: folds 
Uncalled bet ($0.38) returned to VaDilin
VaDilin collected $0.60 from pot
VaDilin: doesn't show hand 
*** SUMMARY ***
Total pot $0.62 | Rake $0.02 
Board [6c 5d Jh 3s]
Seat 1: bakugn (button) folded before Flop (didn't bet)
Seat 2: deoxy1909 (small blind) folded on the Turn
Seat 3: wkulig (big blind) folded before Flop
Seat 4: innacente folded before Flop (didn't bet)
Seat 5: VaDilin collected ($0.60)
Seat 6: marcel046 folded before Flop (didn't bet)



PokerStars Zoom Hand #120991790969:  Hold'em No Limit ($0.01/$0.02) - 2014/09/03 5:04:42 ET
Table 'Halley' 6-max Seat #1 is the button
Seat 1: deoxy1909 ($0.82 in chips) 
Seat 2: Zeoma ($0.60 in chips) 
Seat 3: manowar7771 ($3.14 in chips) 
Seat 4: barryalaned ($2.72 in chips) 
Seat 5: zzzbenjamin ($0.85 in chips) 
Seat 6: str12380 ($4.90 in chips) 
Zeoma: posts small blind $0.01
manowar7771: posts big blind $0.02
*** HOLE CARDS ***
Dealt to deoxy1909 [4s 6d]
barryalaned: folds 
zzzbenjamin: calls $0.02
str12380: folds 
deoxy1909: folds 
Zeoma: folds 
manowar7771: raises $0.06 to $0.08
zzzbenjamin: calls $0.06
*** FLOP *** [Qs 9c 6h]
manowar7771: bets $0.20
zzzbenjamin: calls $0.20
*** TURN *** [Qs 9c 6h] [Ad]
manowar7771: checks 
zzzbenjamin: checks 
*** RIVER *** [Qs 9c 6h Ad] [2h]
manowar7771: checks 
zzzbenjamin: checks 
*** SHOW DOWN ***
manowar7771: shows [5c 5d] (a pair of Fives)
zzzbenjamin: shows [Ks Qd] (a pair of Queens)
zzzbenjamin collected $0.55 from pot
*** SUMMARY ***
Total pot $0.57 | Rake $0.02 
Board [Qs 9c 6h Ad 2h]
Seat 1: deoxy1909 (button) folded before Flop (didn't bet)
Seat 2: Zeoma (small blind) folded before Flop
Seat 3: manowar7771 (big blind) showed [5c 5d] and lost with a pair of Fives
Seat 4: barryalaned folded before Flop (didn't bet)
Seat 5: zzzbenjamin showed [Ks Qd] and won ($0.55) with a pair of Queens
Seat 6: str12380 folded before Flop (didn't bet)



PokerStars Zoom Hand #120991824363:  Hold'em No Limit ($0.01/$0.02) - 2014/09/03 5:06:08 ET
Table 'Halley' 6-max Seat #1 is the button
Seat 1: deoxy1909 ($0.88 in chips) 
Seat 2: dampovip ($2 in chips) 
Seat 3: amomti ($1.88 in chips) 
Seat 4: Masa kissed ($6.02 in chips) 
Seat 5: crahardja ($1.60 in chips) 
Seat 6: Volshebnic72 ($2.11 in chips) 
dampovip: posts small blind $0.01
amomti: posts big blind $0.02
*** HOLE CARDS ***
Dealt to deoxy1909 [Js Ad]
Masa kissed: folds 
crahardja: folds 
Volshebnic72: folds 
deoxy1909: raises $0.04 to $0.06
dampovip: raises $0.14 to $0.20
amomti: calls $0.18
deoxy1909: folds 
*** FLOP *** [4c 8h 7h]
dampovip: bets $0.30
amomti: calls $0.30
*** TURN *** [4c 8h 7h] [Qh]
dampovip: checks 
amomti: checks 
*** RIVER *** [4c 8h 7h Qh] [4d]
dampovip: bets $0.20
amomti: raises $0.71 to $0.91
dampovip: folds 
Uncalled bet ($0.71) returned to amomti
amomti collected $1.41 from pot
amomti: doesn't show hand 
*** SUMMARY ***
Total pot $1.46 | Rake $0.05 
Board [4c 8h 7h Qh 4d]
Seat 1: deoxy1909 (button) folded before Flop
Seat 2: dampovip (small blind) folded on the River
Seat 3: amomti (big blind) collected ($1.41)
Seat 4: Masa kissed folded before Flop (didn't bet)
Seat 5: crahardja folded before Flop (didn't bet)
Seat 6: Volshebnic72 folded before Flop (didn't bet)



PokerStars Zoom Hand #120991834119:  Hold'em No Limit ($0.01/$0.02) - 2014/09/03 5:06:33 ET
Table 'Halley' 6-max Seat #1 is the button
Seat 1: ChrisPobs ($2.82 in chips) 
Seat 2: deoxy1909 ($0.82 in chips) 
Seat 3: csimodr ($2.58 in chips) 
Seat 4: devoon83 ($2.34 in chips) 
Seat 5: gansini818 ($2.10 in chips) 
Seat 6: Bayazet ($2.38 in chips) 
deoxy1909: posts small blind $0.01
csimodr: posts big blind $0.02
*** HOLE CARDS ***
Dealt to deoxy1909 [4c Ks]
devoon83: raises $0.02 to $0.04
gansini818: calls $0.04
Bayazet: folds 
ChrisPobs: folds 
deoxy1909: folds 
csimodr: folds 
*** FLOP *** [3d 2d 4s]
devoon83: bets $0.08
gansini818: raises $0.14 to $0.22
devoon83: calls $0.14
*** TURN *** [3d 2d 4s] [8s]
devoon83: bets $0.10
gansini818: calls $0.10
*** RIVER *** [3d 2d 4s 8s] [2h]
devoon83: bets $1.98 and is all-in
gansini818: folds 
Uncalled bet ($1.98) returned to devoon83
devoon83 collected $0.72 from pot
devoon83: doesn't show hand 
*** SUMMARY ***
Total pot $0.75 | Rake $0.03 
Board [3d 2d 4s 8s 2h]
Seat 1: ChrisPobs (button) folded before Flop (didn't bet)
Seat 2: deoxy1909 (small blind) folded before Flop
Seat 3: csimodr (big blind) folded before Flop
Seat 4: devoon83 collected ($0.72)
Seat 5: gansini818 folded on the River
Seat 6: Bayazet folded before Flop (didn't bet)



PokerStars Zoom Hand #120991849545:  Hold'em No Limit ($0.01/$0.02) - 2014/09/03 5:07:13 ET
Table 'Halley' 6-max Seat #1 is the button
Seat 1: schewwwww ($2.17 in chips) 
Seat 2: JCole94 ($1.97 in chips) 
Seat 3: Slave121 ($2.24 in chips) 
Seat 4: YaoSoon ($2.11 in chips) 
Seat 5: deoxy1909 ($0.82 in chips) 
Seat 6: 14curlstef3 ($1.98 in chips) 
JCole94: posts small blind $0.01
Slave121: posts big blind $0.02
*** HOLE CARDS ***
Dealt to deoxy1909 [Js Qh]
YaoSoon: raises $0.04 to $0.06
deoxy1909: calls $0.06
14curlstef3: folds 
schewwwww: folds 
JCole94: calls $0.05
Slave121: folds 
*** FLOP *** [9c Qs Qd]
JCole94: checks 
YaoSoon: checks 
deoxy1909: bets $0.12
JCole94: folds 
YaoSoon: raises $0.18 to $0.30
deoxy1909: calls $0.18
*** TURN *** [9c Qs Qd] [9d]
YaoSoon: checks 
deoxy1909: bets $0.46 and is all-in
YaoSoon: folds 
Uncalled bet ($0.46) returned to deoxy1909
deoxy1909 collected $0.77 from pot
deoxy1909: doesn't show hand 
*** SUMMARY ***
Total pot $0.80 | Rake $0.03 
Board [9c Qs Qd 9d]
Seat 1: schewwwww (button) folded before Flop (didn't bet)
Seat 2: JCole94 (small blind) folded on the Flop
Seat 3: Slave121 (big blind) folded before Flop
Seat 4: YaoSoon folded on the Turn
Seat 5: deoxy1909 collected ($0.77)
Seat 6: 14curlstef3 folded before Flop (didn't bet)



PokerStars Zoom Hand #120992035008:  Hold'em No Limit ($0.01/$0.02) - 2014/09/03 5:15:08 ET
Table 'Halley' 6-max Seat #1 is the button
Seat 1: Brmbek ($2.24 in chips) 
Seat 2: xSefNx ($1.45 in chips) 
Seat 3: deoxy1909 ($1.04 in chips) 
Seat 4: vertuxay ($2 in chips) 
Seat 5: eugen198030 ($1.79 in chips) 
Seat 6: ABTOMAT ($2.85 in chips) 
xSefNx: posts small blind $0.01
deoxy1909: posts big blind $0.02
*** HOLE CARDS ***
Dealt to deoxy1909 [3s 6h]
vertuxay: raises $0.03 to $0.05
eugen198030: folds 
ABTOMAT: folds 
Brmbek: calls $0.05
xSefNx: folds 
deoxy1909: folds 
*** FLOP *** [3d Js 4h]
vertuxay: checks 
Brmbek: bets $0.09
vertuxay: calls $0.09
*** TURN *** [3d Js 4h] [7h]
vertuxay: checks 
Brmbek: bets $0.22
vertuxay: calls $0.22
*** RIVER *** [3d Js 4h 7h] [3c]
vertuxay: checks 
Brmbek: checks 
*** SHOW DOWN ***
vertuxay: shows [9c 9s] (two pair, Nines and Threes)
Brmbek: mucks hand 
vertuxay collected $0.72 from pot
*** SUMMARY ***
Total pot $0.75 | Rake $0.03 
Board [3d Js 4h 7h 3c]
Seat 1: Brmbek (button) mucked [8s 8c]
Seat 2: xSefNx (small blind) folded before Flop
Seat 3: deoxy1909 (big blind) folded before Flop
Seat 4: vertuxay showed [9c 9s] and won ($0.72) with two pair, Nines and Threes
Seat 5: eugen198030 folded before Flop (didn't bet)
Seat 6: ABTOMAT folded before Flop (didn't bet)



PokerStars Zoom Hand #120992325833:  Hold'em No Limit ($0.01/$0.02) - 2014/09/03 5:27:06 ET
Table 'Halley' 6-max Seat #1 is the button
Seat 1: Pancha0307 ($1.15 in chips) 
Seat 2: JoeBacsi911 ($2.16 in chips) 
Seat 3: deoxy1909 ($0.89 in chips) 
Seat 4: MrGehaktbal ($2 in chips) 
Seat 5: Roger_THC87 ($2.04 in chips) 
Seat 6: ffev78 ($2.41 in chips) 
JoeBacsi911: posts small blind $0.01
deoxy1909: posts big blind $0.02
*** HOLE CARDS ***
Dealt to deoxy1909 [Ks Kh]
MrGehaktbal: folds 
Roger_THC87: raises $0.02 to $0.04
ffev78: folds 
Pancha0307: calls $0.04
JoeBacsi911: folds 
deoxy1909: raises $0.12 to $0.16
Roger_THC87: calls $0.12
Pancha0307: calls $0.12
*** FLOP *** [3h 8c 6h]
deoxy1909: bets $0.34
Roger_THC87: raises $0.34 to $0.68
Pancha0307: folds 
deoxy1909: calls $0.34
*** TURN *** [3h 8c 6h] [2c]
deoxy1909: bets $0.05 and is all-in
Roger_THC87: calls $0.05
*** RIVER *** [3h 8c 6h 2c] [Jd]
*** SHOW DOWN ***
deoxy1909: shows [Ks Kh] (a pair of Kings)
Roger_THC87: mucks hand 
deoxy1909 collected $1.88 from pot
*** SUMMARY ***
Total pot $1.95 | Rake $0.07 
Board [3h 8c 6h 2c Jd]
Seat 1: Pancha0307 (button) folded on the Flop
Seat 2: JoeBacsi911 (small blind) folded before Flop
Seat 3: deoxy1909 (big blind) showed [Ks Kh] and won ($1.88) with a pair of Kings
Seat 4: MrGehaktbal folded before Flop (didn't bet)
Seat 5: Roger_THC87 mucked [8h Ad]
Seat 6: ffev78 folded before Flop (didn't bet)



PokerStars Zoom Hand #120992479233:  Hold'em No Limit ($0.01/$0.02) - 2014/09/03 5:33:19 ET
Table 'Halley' 6-max Seat #1 is the button
Seat 1: urgent24/7 ($2 in chips) 
Seat 2: deoxy1909 ($1.81 in chips) 
Seat 3: pandretito ($0.81 in chips) 
Seat 4: drwal286 ($2 in chips) 
Seat 5: andriyno2 ($0.80 in chips) 
Seat 6: graham1114 ($2.57 in chips) 
deoxy1909: posts small blind $0.01
pandretito: posts big blind $0.02
*** HOLE CARDS ***
Dealt to deoxy1909 [8h 2c]
drwal286: folds 
andriyno2: raises $0.78 to $0.80 and is all-in
graham1114: folds 
urgent24/7: calls $0.80
deoxy1909: folds 
pandretito: folds 
*** FLOP *** [3c 6s Ah]
*** TURN *** [3c 6s Ah] [5c]
*** RIVER *** [3c 6s Ah 5c] [8c]
*** SHOW DOWN ***
andriyno2: shows [Qd Ac] (a pair of Aces)
urgent24/7: shows [Kd Kh] (a pair of Kings)
andriyno2 collected $1.57 from pot
*** SUMMARY ***
Total pot $1.63 | Rake $0.06 
Board [3c 6s Ah 5c 8c]
Seat 1: urgent24/7 (button) showed [Kd Kh] and lost with a pair of Kings
Seat 2: deoxy1909 (small blind) folded before Flop
Seat 3: pandretito (big blind) folded before Flop
Seat 4: drwal286 folded before Flop (didn't bet)
Seat 5: andriyno2 showed [Qd Ac] and won ($1.57) with a pair of Aces
Seat 6: graham1114 folded before Flop (didn't bet)



PokerStars Zoom Hand #120992480906:  Hold'em No Limit ($0.01/$0.02) - 2014/09/03 5:33:23 ET
Table 'Halley' 6-max Seat #1 is the button
Seat 1: deoxy1909 ($1.80 in chips) 
Seat 2: Keszii ($2.31 in chips) 
Seat 3: smahatma ($1.87 in chips) 
Seat 4: muhata_10 ($0.58 in chips) 
Seat 5: kallinfm ($1.60 in chips) 
Seat 6: Dardyunna ($2.42 in chips) 
Keszii: posts small blind $0.01
smahatma: posts big blind $0.02
*** HOLE CARDS ***
Dealt to deoxy1909 [Th Ah]
muhata_10: calls $0.02
kallinfm: calls $0.02
Dardyunna: folds 
deoxy1909: raises $0.08 to $0.10
Keszii: folds 
smahatma: folds 
muhata_10: calls $0.08
kallinfm: calls $0.08
*** FLOP *** [Kd Qs 6d]
muhata_10: checks 
kallinfm: checks 
deoxy1909: checks 
*** TURN *** [Kd Qs 6d] [Tc]
muhata_10: bets $0.32
kallinfm: calls $0.32
deoxy1909: folds 
*** RIVER *** [Kd Qs 6d Tc] [Qh]
muhata_10: bets $0.16 and is all-in
kallinfm: calls $0.16
*** SHOW DOWN ***
muhata_10: shows [2s Ks] (two pair, Kings and Queens)
kallinfm: shows [Js Ts] (two pair, Queens and Tens)
muhata_10 collected $1.24 from pot
*** SUMMARY ***
Total pot $1.29 | Rake $0.05 
Board [Kd Qs 6d Tc Qh]
Seat 1: deoxy1909 (button) folded on the Turn
Seat 2: Keszii (small blind) folded before Flop
Seat 3: smahatma (big blind) folded before Flop
Seat 4: muhata_10 showed [2s Ks] and won ($1.24) with two pair, Kings and Queens
Seat 5: kallinfm showed [Js Ts] and lost with two pair, Queens and Tens
Seat 6: Dardyunna folded before Flop (didn't bet)



PokerStars Zoom Hand #120992532191:  Hold'em No Limit ($0.01/$0.02) - 2014/09/03 5:35:27 ET
Table 'Halley' 6-max Seat #1 is the button
Seat 1: sywlwy ($1.35 in chips) 
Seat 2: Piluch ($1.15 in chips) 
Seat 3: deoxy1909 ($1.73 in chips) 
Seat 4: hazelwood11 ($1.71 in chips) 
Seat 5: P.K.45677 ($2.55 in chips) 
Seat 6: hunk3r ($2 in chips) 
Piluch: posts small blind $0.01
deoxy1909: posts big blind $0.02
*** HOLE CARDS ***
Dealt to deoxy1909 [Ad 2s]
hazelwood11: folds 
P.K.45677: folds 
hunk3r: raises $0.04 to $0.06
sywlwy: calls $0.06
Piluch: calls $0.05
deoxy1909: folds 
*** FLOP *** [9d 4s 6c]
Piluch: checks 
hunk3r: bets $0.13
sywlwy: calls $0.13
Piluch: calls $0.13
*** TURN *** [9d 4s 6c] [7d]
Piluch: bets $0.57
hunk3r: folds 
sywlwy: raises $0.57 to $1.14
Piluch: calls $0.39 and is all-in
Uncalled bet ($0.18) returned to sywlwy
*** RIVER *** [9d 4s 6c 7d] [8s]
*** SHOW DOWN ***
Piluch: shows [As 7s] (a pair of Sevens)
sywlwy: shows [4h 4d] (three of a kind, Fours)
sywlwy collected $2.42 from pot
*** SUMMARY ***
Total pot $2.51 | Rake $0.09 
Board [9d 4s 6c 7d 8s]
Seat 1: sywlwy (button) showed [4h 4d] and won ($2.42) with three of a kind, Fours
Seat 2: Piluch (small blind) showed [As 7s] and lost with a pair of Sevens
Seat 3: deoxy1909 (big blind) folded before Flop
Seat 4: hazelwood11 folded before Flop (didn't bet)
Seat 5: P.K.45677 folded before Flop (didn't bet)
Seat 6: hunk3r folded on the Turn



PokerStars Zoom Hand #120992548342:  Hold'em No Limit ($0.01/$0.02) - 2014/09/03 5:36:06 ET
Table 'Halley' 6-max Seat #1 is the button
Seat 1: deoxy1909 ($1.70 in chips) 
Seat 2: sagrata 12 ($2.49 in chips) 
Seat 3: goldmen91 ($2.21 in chips) 
Seat 4: rotta@poker ($8.02 in chips) 
Seat 5: renador ($3.17 in chips) 
Seat 6: okuchers ($2 in chips) 
sagrata 12: posts small blind $0.01
goldmen91: posts big blind $0.02
*** HOLE CARDS ***
Dealt to deoxy1909 [3c 7s]
rotta@poker: raises $0.05 to $0.07
renador: folds 
okuchers: folds 
deoxy1909: folds 
sagrata 12: raises $0.16 to $0.23
goldmen91: folds 
rotta@poker: calls $0.16
*** FLOP *** [Ts 8c Ks]
sagrata 12: checks 
rotta@poker: checks 
*** TURN *** [Ts 8c Ks] [3d]
sagrata 12: checks 
rotta@poker: checks 
*** RIVER *** [Ts 8c Ks 3d] [Kh]
sagrata 12: checks 
rotta@poker: bets $0.46
sagrata 12: calls $0.46
*** SHOW DOWN ***
rotta@poker: shows [Ah 9c] (a pair of Kings)
sagrata 12: shows [Js Jd] (two pair, Kings and Jacks)
sagrata 12 collected $1.35 from pot
*** SUMMARY ***
Total pot $1.40 | Rake $0.05 
Board [Ts 8c Ks 3d Kh]
Seat 1: deoxy1909 (button) folded before Flop (didn't bet)
Seat 2: sagrata 12 (small blind) showed [Js Jd] and won ($1.35) with two pair, Kings and Jacks
Seat 3: goldmen91 (big blind) folded before Flop
Seat 4: rotta@poker showed [Ah 9c] and lost with a pair of Kings
Seat 5: renador folded before Flop (didn't bet)
Seat 6: okuchers folded before Flop (didn't bet)



PokerStars Zoom Hand #120992677274:  Hold'em No Limit ($0.01/$0.02) - 2014/09/03 5:41:17 ET
Table 'Halley' 6-max Seat #1 is the button
Seat 1: gexownik ($3.65 in chips) 
Seat 2: deoxy1909 ($2.06 in chips) 
Seat 3: nico.r85 ($2.07 in chips) 
Seat 4: Disharmonist ($3.10 in chips) 
Seat 5: Conseclusie ($2.52 in chips) 
Seat 6: Simkooo ($2.64 in chips) 
deoxy1909: posts small blind $0.01
nico.r85: posts big blind $0.02
*** HOLE CARDS ***
Dealt to deoxy1909 [2s 9h]
Disharmonist: raises $0.04 to $0.06
Conseclusie: calls $0.06
Simkooo: folds 
gexownik: calls $0.06
deoxy1909: folds 
nico.r85: calls $0.04
*** FLOP *** [5d Jd 8c]
nico.r85: checks 
Disharmonist: checks 
Conseclusie: bets $0.14
gexownik: calls $0.14
nico.r85: folds 
Disharmonist: folds 
*** TURN *** [5d Jd 8c] [3c]
Conseclusie: bets $0.26
gexownik: calls $0.26
*** RIVER *** [5d Jd 8c 3c] [4d]
Conseclusie: checks 
gexownik: bets $0.50
Conseclusie: folds 
Uncalled bet ($0.50) returned to gexownik
gexownik collected $1.01 from pot
gexownik: doesn't show hand 
*** SUMMARY ***
Total pot $1.05 | Rake $0.04 
Board [5d Jd 8c 3c 4d]
Seat 1: gexownik (button) collected ($1.01)
Seat 2: deoxy1909 (small blind) folded before Flop
Seat 3: nico.r85 (big blind) folded on the Flop
Seat 4: Disharmonist folded on the Flop
Seat 5: Conseclusie folded on the River
Seat 6: Simkooo folded before Flop (didn't bet)



PokerStars Zoom Hand #120992782220:  Hold'em No Limit ($0.01/$0.02) - 2014/09/03 5:45:31 ET
Table 'Halley' 6-max Seat #1 is the button
Seat 1: Ice.B1ood- ($2 in chips) 
Seat 2: Nxt1pls ($2.83 in chips) 
Seat 3: deoxy1909 ($2.07 in chips) 
Seat 4: mohandes81 ($6.55 in chips) 
Seat 5: kilpauk ($2.26 in chips) 
Seat 6: JoeBacsi911 ($0.15 in chips) 
Nxt1pls: posts small blind $0.01
deoxy1909: posts big blind $0.02
*** HOLE CARDS ***
Dealt to deoxy1909 [Jc Js]
mohandes81: folds 
kilpauk: folds 
JoeBacsi911: folds 
Ice.B1ood-: raises $0.04 to $0.06
Nxt1pls: calls $0.05
deoxy1909: raises $0.14 to $0.20
Ice.B1ood-: calls $0.14
Nxt1pls: calls $0.14
*** FLOP *** [Ah 7h 3s]
Nxt1pls: checks 
deoxy1909: checks 
Ice.B1ood-: checks 
*** TURN *** [Ah 7h 3s] [7c]
Nxt1pls: bets $0.42
deoxy1909: folds 
Ice.B1ood-: folds 
Uncalled bet ($0.42) returned to Nxt1pls
Nxt1pls collected $0.58 from pot
Nxt1pls: doesn't show hand 
*** SUMMARY ***
Total pot $0.60 | Rake $0.02 
Board [Ah 7h 3s 7c]
Seat 1: Ice.B1ood- (button) folded on the Turn
Seat 2: Nxt1pls (small blind) collected ($0.58)
Seat 3: deoxy1909 (big blind) folded on the Turn
Seat 4: mohandes81 folded before Flop (didn't bet)
Seat 5: kilpauk folded before Flop (didn't bet)
Seat 6: JoeBacsi911 folded before Flop (didn't bet)



PokerStars Zoom Hand #120992840060:  Hold'em No Limit ($0.01/$0.02) - 2014/09/03 5:47:51 ET
Table 'Halley' 6-max Seat #1 is the button
Seat 1: Packky ($2.96 in chips) 
Seat 2: deoxy1909 ($1.94 in chips) 
Seat 3: pandretito ($0.80 in chips) 
Seat 4: Dangerr44 ($2.65 in chips) 
Seat 5: CGMUKR ($2.24 in chips) 
Seat 6: Zork80 ($2.52 in chips) 
deoxy1909: posts small blind $0.01
pandretito: posts big blind $0.02
*** HOLE CARDS ***
Dealt to deoxy1909 [As Ah]
Dangerr44: folds 
CGMUKR: raises $0.04 to $0.06
Zork80: folds 
Packky: folds 
deoxy1909: raises $0.12 to $0.18
pandretito: folds 
CGMUKR: calls $0.12
*** FLOP *** [9s 6s 6d]
deoxy1909: bets $0.26
CGMUKR: calls $0.26
*** TURN *** [9s 6s 6d] [5c]
deoxy1909: bets $0.66
CGMUKR: folds 
Uncalled bet ($0.66) returned to deoxy1909
deoxy1909 collected $0.87 from pot
deoxy1909: doesn't show hand 
*** SUMMARY ***
Total pot $0.90 | Rake $0.03 
Board [9s 6s 6d 5c]
Seat 1: Packky (button) folded before Flop (didn't bet)
Seat 2: deoxy1909 (small blind) collected ($0.87)
Seat 3: pandretito (big blind) folded before Flop
Seat 4: Dangerr44 folded before Flop (didn't bet)
Seat 5: CGMUKR folded on the Turn
Seat 6: Zork80 folded before Flop (didn't bet)



PokerStars Zoom Hand #120993011987:  Hold'em No Limit ($0.01/$0.02) - 2014/09/03 5:54:47 ET
Table 'Halley' 6-max Seat #1 is the button
Seat 1: LRNDMS ($2 in chips) 
Seat 2: deoxy1909 ($2.52 in chips) 
Seat 3: gin777utd ($2.18 in chips) 
Seat 4: FartunaQQ ($0.99 in chips) 
Seat 5: drwal286 ($2.29 in chips) 
Seat 6: 171112 ($2.16 in chips) 
deoxy1909: posts small blind $0.01
gin777utd: posts big blind $0.02
*** HOLE CARDS ***
Dealt to deoxy1909 [Ah Ac]
FartunaQQ: raises $0.02 to $0.04
drwal286: folds 
171112: folds 
LRNDMS: folds 
deoxy1909: raises $0.08 to $0.12
gin777utd: folds 
FartunaQQ: calls $0.08
*** FLOP *** [6s 6h Qd]
deoxy1909: bets $0.18
FartunaQQ: calls $0.18
*** TURN *** [6s 6h Qd] [Kh]
deoxy1909: bets $0.44
FartunaQQ: calls $0.44
*** RIVER *** [6s 6h Qd Kh] [5d]
deoxy1909: bets $1.78 and is all-in
FartunaQQ: calls $0.25 and is all-in
Uncalled bet ($1.53) returned to deoxy1909
*** SHOW DOWN ***
deoxy1909: shows [Ah Ac] (two pair, Aces and Sixes)
FartunaQQ: shows [6c Ad] (three of a kind, Sixes)
FartunaQQ collected $1.93 from pot
*** SUMMARY ***
Total pot $2 | Rake $0.07 
Board [6s 6h Qd Kh 5d]
Seat 1: LRNDMS (button) folded before Flop (didn't bet)
Seat 2: deoxy1909 (small blind) showed [Ah Ac] and lost with two pair, Aces and Sixes
Seat 3: gin777utd (big blind) folded before Flop
Seat 4: FartunaQQ showed [6c Ad] and won ($1.93) with three of a kind, Sixes
Seat 5: drwal286 folded before Flop (didn't bet)
Seat 6: 171112 folded before Flop (didn't bet)



PokerStars Zoom Hand #120993129714:  Hold'em No Limit ($0.01/$0.02) - 2014/09/03 6:00:18 ET
Table 'Halley' 6-max Seat #1 is the button
Seat 1: deoxy1909 ($1.46 in chips) 
Seat 2: Graf xx Zahl ($2.37 in chips) 
Seat 3: Inge FuFu ($2.28 in chips) 
Seat 4: trelos24 ($2.05 in chips) 
Seat 5: callmybluf65 ($1.47 in chips) 
Seat 6: Krab506 ($2.15 in chips) 
Graf xx Zahl: posts small blind $0.01
Inge FuFu: posts big blind $0.02
*** HOLE CARDS ***
Dealt to deoxy1909 [Kh 7h]
trelos24: folds 
callmybluf65: calls $0.02
Krab506: folds 
deoxy1909: folds 
Graf xx Zahl: folds 
Inge FuFu: raises $0.18 to $0.20
callmybluf65: calls $0.18
*** FLOP *** [9d 4c Js]
Inge FuFu: bets $0.40
callmybluf65: calls $0.40
*** TURN *** [9d 4c Js] [7c]
Inge FuFu: bets $0.77
callmybluf65: folds 
Uncalled bet ($0.77) returned to Inge FuFu
Inge FuFu collected $1.17 from pot
Inge FuFu: doesn't show hand 
*** SUMMARY ***
Total pot $1.21 | Rake $0.04 
Board [9d 4c Js 7c]
Seat 1: deoxy1909 (button) folded before Flop (didn't bet)
Seat 2: Graf xx Zahl (small blind) folded before Flop
Seat 3: Inge FuFu (big blind) collected ($1.17)
Seat 4: trelos24 folded before Flop (didn't bet)
Seat 5: callmybluf65 folded on the Turn
Seat 6: Krab506 folded before Flop (didn't bet)



PokerStars Zoom Hand #120993134162:  Hold'em No Limit ($0.01/$0.02) - 2014/09/03 6:00:30 ET
Table 'Halley' 6-max Seat #1 is the button
Seat 1: Player_BY ($0.39 in chips) 
Seat 2: LOPE208 ($2 in chips) 
Seat 3: deoxy1909 ($1.45 in chips) 
Seat 4: Triguba ($2.35 in chips) 
Seat 5: MrNobody346 ($1.28 in chips) 
Seat 6: ol.sh555 ($0.51 in chips) 
LOPE208: posts small blind $0.01
deoxy1909: posts big blind $0.02
*** HOLE CARDS ***
Dealt to deoxy1909 [9d Td]
Triguba: folds 
MrNobody346: calls $0.02
ol.sh555: calls $0.02
Player_BY: folds 
LOPE208: raises $0.06 to $0.08
deoxy1909: folds 
MrNobody346: calls $0.06
ol.sh555: calls $0.06
*** FLOP *** [3s Qc 5s]
LOPE208: bets $0.16
MrNobody346: raises $1.04 to $1.20 and is all-in
ol.sh555: calls $0.43 and is all-in
LOPE208: folds 
Uncalled bet ($0.77) returned to MrNobody346
*** TURN *** [3s Qc 5s] [2h]
*** RIVER *** [3s Qc 5s 2h] [Ah]
*** SHOW DOWN ***
MrNobody346: shows [Qs Ac] (two pair, Aces and Queens)
ol.sh555: shows [Kc 6c] (high card Ace)
MrNobody346 collected $1.24 from pot
*** SUMMARY ***
Total pot $1.28 | Rake $0.04 
Board [3s Qc 5s 2h Ah]
Seat 1: Player_BY (button) folded before Flop (didn't bet)
Seat 2: LOPE208 (small blind) folded on the Flop
Seat 3: deoxy1909 (big blind) folded before Flop
Seat 4: Triguba folded before Flop (didn't bet)
Seat 5: MrNobody346 showed [Qs Ac] and won ($1.24) with two pair, Aces and Queens
Seat 6: ol.sh555 showed [Kc 6c] and lost with high card Ace



PokerStars Zoom Hand #120993259002:  Hold'em No Limit ($0.01/$0.02) - 2014/09/03 6:05:24 ET
Table 'Halley' 6-max Seat #1 is the button
Seat 1: DIMETRIO3 ($2 in chips) 
Seat 2: DimisM ($1.80 in chips) 
Seat 3: deoxy1909 ($1.10 in chips) 
Seat 4: bullof ($7.55 in chips) 
Seat 5: Dreacu ($2.74 in chips) 
Seat 6: mohandes81 ($2.24 in chips) 
DimisM: posts small blind $0.01
deoxy1909: posts big blind $0.02
*** HOLE CARDS ***
Dealt to deoxy1909 [Jd 2d]
bullof has timed out
bullof: folds 
Dreacu: raises $0.04 to $0.06
mohandes81: folds 
DIMETRIO3: raises $0.12 to $0.18
DimisM: calls $0.17
deoxy1909: folds 
Dreacu: calls $0.12
*** FLOP *** [Th Ks 4c]
DimisM: bets $0.04
Dreacu: folds 
DIMETRIO3 is connected 
DIMETRIO3: raises $0.36 to $0.40
DimisM: folds 
Uncalled bet ($0.36) returned to DIMETRIO3
DIMETRIO3 collected $0.62 from pot
DIMETRIO3: doesn't show hand 
*** SUMMARY ***
Total pot $0.64 | Rake $0.02 
Board [Th Ks 4c]
Seat 1: DIMETRIO3 (button) collected ($0.62)
Seat 2: DimisM (small blind) folded on the Flop
Seat 3: deoxy1909 (big blind) folded before Flop
Seat 4: bullof folded before Flop (didn't bet)
Seat 5: Dreacu folded on the Flop
Seat 6: mohandes81 folded before Flop (didn't bet)



PokerStars Zoom Hand #120993428052:  Hold'em No Limit ($0.01/$0.02) - 2014/09/03 6:11:45 ET
Table 'Halley' 6-max Seat #1 is the button
Seat 1: Devi1Rigo11 ($2.06 in chips) 
Seat 2: lis_diman001 ($1.08 in chips) 
Seat 3: BoBoNe93 ($2.41 in chips) 
Seat 4: deoxy1909 ($0.86 in chips) 
Seat 5: Triguba ($2.01 in chips) 
Seat 6: weri gud ($1.01 in chips) 
lis_diman001: posts small blind $0.01
BoBoNe93: posts big blind $0.02
*** HOLE CARDS ***
Dealt to deoxy1909 [Kh Qs]
deoxy1909: raises $0.04 to $0.06
Triguba: folds 
weri gud: folds 
Devi1Rigo11: folds 
lis_diman001: calls $0.05
BoBoNe93: folds 
*** FLOP *** [Qh 9s 4c]
lis_diman001: checks 
deoxy1909: bets $0.08
lis_diman001: calls $0.08
*** TURN *** [Qh 9s 4c] [Ah]
lis_diman001: checks 
deoxy1909: bets $0.20
lis_diman001: calls $0.20
*** RIVER *** [Qh 9s 4c Ah] [7h]
lis_diman001: checks 
deoxy1909: checks 
*** SHOW DOWN ***
lis_diman001: shows [Qc 3s] (a pair of Queens)
deoxy1909: shows [Kh Qs] (a pair of Queens - Ace+King kicker)
deoxy1909 collected $0.68 from pot
*** SUMMARY ***
Total pot $0.70 | Rake $0.02 
Board [Qh 9s 4c Ah 7h]
Seat 1: Devi1Rigo11 (button) folded before Flop (didn't bet)
Seat 2: lis_diman001 (small blind) showed [Qc 3s] and lost with a pair of Queens
Seat 3: BoBoNe93 (big blind) folded before Flop
Seat 4: deoxy1909 showed [Kh Qs] and won ($0.68) with a pair of Queens
Seat 5: Triguba folded before Flop (didn't bet)
Seat 6: weri gud folded before Flop (didn't bet)



PokerStars Zoom Hand #120993577920:  Hold'em No Limit ($0.01/$0.02) - 2014/09/03 6:17:19 ET
Table 'Halley' 6-max Seat #1 is the button
Seat 1: deoxy1909 ($1.11 in chips) 
Seat 2: Kostrov A. ($2 in chips) 
Seat 3: Nonosha ($2.99 in chips) 
Seat 4: luger1991 ($2.55 in chips) 
Seat 5: boss2886 ($2.10 in chips) 
Seat 6: DIMETRIO3 ($2.01 in chips) 
Kostrov A.: posts small blind $0.01
Nonosha: posts big blind $0.02
*** HOLE CARDS ***
Dealt to deoxy1909 [2h Ac]
luger1991: folds 
boss2886: folds 
DIMETRIO3: folds 
deoxy1909: folds 
Kostrov A.: raises $0.04 to $0.06
Nonosha: raises $0.12 to $0.18
Kostrov A.: raises $0.38 to $0.56
Nonosha: raises $2.43 to $2.99 and is all-in
Kostrov A.: calls $1.44 and is all-in
Uncalled bet ($0.99) returned to Nonosha
*** FLOP *** [6s 9h 2d]
*** TURN *** [6s 9h 2d] [7d]
*** RIVER *** [6s 9h 2d 7d] [Jc]
*** SHOW DOWN ***
Kostrov A.: shows [Js Jd] (three of a kind, Jacks)
Nonosha: shows [As Ks] (high card Ace)
Kostrov A. collected $3.86 from pot
*** SUMMARY ***
Total pot $4 | Rake $0.14 
Board [6s 9h 2d 7d Jc]
Seat 1: deoxy1909 (button) folded before Flop (didn't bet)
Seat 2: Kostrov A. (small blind) showed [Js Jd] and won ($3.86) with three of a kind, Jacks
Seat 3: Nonosha (big blind) showed [As Ks] and lost with high card Ace
Seat 4: luger1991 folded before Flop (didn't bet)
Seat 5: boss2886 folded before Flop (didn't bet)
Seat 6: DIMETRIO3 folded before Flop (didn't bet)



PokerStars Zoom Hand #120993594376:  Hold'em No Limit ($0.01/$0.02) - 2014/09/03 6:17:56 ET
Table 'Halley' 6-max Seat #1 is the button
Seat 1: deoxy1909 ($1.11 in chips) 
Seat 2: Sk1pN ($4.88 in chips) 
Seat 3: tencp ($2.15 in chips) 
Seat 4: fantasmão0 ($3.85 in chips) 
Seat 5: bullof ($2.97 in chips) 
Seat 6: mrissya33 ($2.66 in chips) 
Sk1pN: posts small blind $0.01
tencp: posts big blind $0.02
*** HOLE CARDS ***
Dealt to deoxy1909 [Jd 2c]
fantasmão0: folds 
bullof: folds 
mrissya33: folds 
deoxy1909: folds 
Sk1pN: raises $0.04 to $0.06
tencp: raises $0.12 to $0.18
Sk1pN: raises $4.70 to $4.88 and is all-in
tencp: calls $1.97 and is all-in
Uncalled bet ($2.73) returned to Sk1pN
*** FLOP *** [Ah Td 6c]
*** TURN *** [Ah Td 6c] [3h]
*** RIVER *** [Ah Td 6c 3h] [Ks]
*** SHOW DOWN ***
Sk1pN: shows [Ad Ac] (three of a kind, Aces)
tencp: shows [Qs Qc] (a pair of Queens)
Sk1pN collected $4.15 from pot
*** SUMMARY ***
Total pot $4.30 | Rake $0.15 
Board [Ah Td 6c 3h Ks]
Seat 1: deoxy1909 (button) folded before Flop (didn't bet)
Seat 2: Sk1pN (small blind) showed [Ad Ac] and won ($4.15) with three of a kind, Aces
Seat 3: tencp (big blind) showed [Qs Qc] and lost with a pair of Queens
Seat 4: fantasmão0 folded before Flop (didn't bet)
Seat 5: bullof folded before Flop (didn't bet)
Seat 6: mrissya33 folded before Flop (didn't bet)



PokerStars Zoom Hand #120993592639:  Hold'em No Limit ($0.01/$0.02) - 2014/09/03 6:17:52 ET
Table 'Halley' 6-max Seat #1 is the button
Seat 1: F63.00 ($2 in chips) 
Seat 2: deoxy1909 ($1.12 in chips) 
Seat 3: Doob1974 ($0.99 in chips) 
Seat 4: fandorin2007 ($5.22 in chips) 
Seat 5: hitman_alex ($1.52 in chips) 
Seat 6: devil1337 ($2.11 in chips) 
deoxy1909: posts small blind $0.01
Doob1974: posts big blind $0.02
*** HOLE CARDS ***
Dealt to deoxy1909 [Kc 7d]
fandorin2007: folds 
hitman_alex: folds 
devil1337: raises $0.04 to $0.06
F63.00: raises $0.12 to $0.18
deoxy1909: folds 
Doob1974: calls $0.16
devil1337: folds 
*** FLOP *** [Qh 8h Qd]
Doob1974: bets $0.02
F63.00: raises $0.08 to $0.10
Doob1974: calls $0.08
*** TURN *** [Qh 8h Qd] [6d]
Doob1974: bets $0.02
F63.00: raises $0.18 to $0.20
Doob1974: calls $0.18
*** RIVER *** [Qh 8h Qd 6d] [2c]
Doob1974: checks 
F63.00: bets $1.52 and is all-in
Doob1974: folds 
Uncalled bet ($1.52) returned to F63.00
F63.00 collected $0.99 from pot
F63.00: doesn't show hand 
*** SUMMARY ***
Total pot $1.03 | Rake $0.04 
Board [Qh 8h Qd 6d 2c]
Seat 1: F63.00 (button) collected ($0.99)
Seat 2: deoxy1909 (small blind) folded before Flop
Seat 3: Doob1974 (big blind) folded on the River
Seat 4: fandorin2007 folded before Flop (didn't bet)
Seat 5: hitman_alex folded before Flop (didn't bet)
Seat 6: devil1337 folded before Flop



PokerStars Zoom Hand #120993595719:  Hold'em No Limit ($0.01/$0.02) - 2014/09/03 6:17:59 ET
Table 'Halley' 6-max Seat #1 is the button
Seat 1: `Wid0ka$` ($2.19 in chips) 
Seat 2: mohandes81 ($2 in chips) 
Seat 3: deoxy1909 ($1.11 in chips) 
Seat 4: StrangRF ($2.03 in chips) 
Seat 5: shav0str8s ($4.89 in chips) 
Seat 6: ptakislimak ($1.43 in chips) 
mohandes81: posts small blind $0.01
deoxy1909: posts big blind $0.02
*** HOLE CARDS ***
Dealt to deoxy1909 [4s Jd]
StrangRF: folds 
shav0str8s: raises $0.02 to $0.04
ptakislimak: folds 
`Wid0ka$`: folds 
mohandes81: calls $0.03
deoxy1909: folds 
*** FLOP *** [9h Kd Th]
mohandes81: checks 
shav0str8s: bets $0.10
mohandes81: raises $0.18 to $0.28
shav0str8s: calls $0.18
*** TURN *** [9h Kd Th] [4d]
mohandes81: checks 
shav0str8s: bets $0.32
mohandes81: folds 
Uncalled bet ($0.32) returned to shav0str8s
shav0str8s collected $0.64 from pot
shav0str8s: doesn't show hand 
*** SUMMARY ***
Total pot $0.66 | Rake $0.02 
Board [9h Kd Th 4d]
Seat 1: `Wid0ka$` (button) folded before Flop (didn't bet)
Seat 2: mohandes81 (small blind) folded on the Turn
Seat 3: deoxy1909 (big blind) folded before Flop
Seat 4: StrangRF folded before Flop (didn't bet)
Seat 5: shav0str8s collected ($0.64)
Seat 6: ptakislimak folded before Flop (didn't bet)



PokerStars Zoom Hand #120993637213:  Hold'em No Limit ($0.01/$0.02) - 2014/09/03 6:19:31 ET
Table 'Halley' 6-max Seat #1 is the button
Seat 1: bertche ($1.41 in chips) 
Seat 2: deoxy1909 ($0.98 in chips) 
Seat 3: d3nc ($5.63 in chips) 
Seat 4: maestro19711 ($2.10 in chips) 
Seat 5: BigTanya ($0.32 in chips) 
Seat 6: Tomjibk ($1.03 in chips) 
deoxy1909: posts small blind $0.01
d3nc: posts big blind $0.02
*** HOLE CARDS ***
Dealt to deoxy1909 [Ts 7h]
maestro19711: folds 
BigTanya: folds 
Tomjibk: folds 
bertche: raises $0.02 to $0.04
deoxy1909: folds 
d3nc: raises $0.10 to $0.14
bertche: calls $0.10
*** FLOP *** [9h 6s 2d]
d3nc: checks 
bertche: checks 
*** TURN *** [9h 6s 2d] [Kd]
d3nc: bets $0.18
bertche: calls $0.18
*** RIVER *** [9h 6s 2d Kd] [Qh]
d3nc: checks 
bertche: checks 
*** SHOW DOWN ***
d3nc: shows [As Kc] (a pair of Kings)
bertche: shows [Qs Js] (a pair of Queens)
d3nc collected $0.63 from pot
*** SUMMARY ***
Total pot $0.65 | Rake $0.02 
Board [9h 6s 2d Kd Qh]
Seat 1: bertche (button) showed [Qs Js] and lost with a pair of Queens
Seat 2: deoxy1909 (small blind) folded before Flop
Seat 3: d3nc (big blind) showed [As Kc] and won ($0.63) with a pair of Kings
Seat 4: maestro19711 folded before Flop (didn't bet)
Seat 5: BigTanya folded before Flop (didn't bet)
Seat 6: Tomjibk folded before Flop (didn't bet)



PokerStars Zoom Hand #120993698587:  Hold'em No Limit ($0.01/$0.02) - 2014/09/03 6:21:48 ET
Table 'Halley' 6-max Seat #1 is the button
Seat 1: deoxy1909 ($0.83 in chips) 
Seat 2: spacer510 ($2 in chips) 
Seat 3: WeiFengLiu ($6.19 in chips) 
Seat 4: Unfreguented ($2.23 in chips) 
Seat 5: dsviridovich ($3.29 in chips) 
Seat 6: Itsalmost ($2.37 in chips) 
spacer510: posts small blind $0.01
WeiFengLiu: posts big blind $0.02
*** HOLE CARDS ***
Dealt to deoxy1909 [8c 5h]
Unfreguented: folds 
dsviridovich: folds 
Itsalmost: raises $0.03 to $0.05
deoxy1909: folds 
spacer510: calls $0.04
WeiFengLiu: folds 
*** FLOP *** [4s 5s Kc]
spacer510: checks 
Itsalmost: bets $0.12
spacer510: raises $0.12 to $0.24
Itsalmost: calls $0.12
*** TURN *** [4s 5s Kc] [8s]
spacer510: checks 
Itsalmost: checks 
*** RIVER *** [4s 5s Kc 8s] [7c]
spacer510: checks 
Itsalmost: bets $0.29
spacer510: folds 
Uncalled bet ($0.29) returned to Itsalmost
Itsalmost collected $0.58 from pot
Itsalmost: doesn't show hand 
*** SUMMARY ***
Total pot $0.60 | Rake $0.02 
Board [4s 5s Kc 8s 7c]
Seat 1: deoxy1909 (button) folded before Flop (didn't bet)
Seat 2: spacer510 (small blind) folded on the River
Seat 3: WeiFengLiu (big blind) folded before Flop
Seat 4: Unfreguented folded before Flop (didn't bet)
Seat 5: dsviridovich folded before Flop (didn't bet)
Seat 6: Itsalmost collected ($0.58)



PokerStars Zoom Hand #120993727149:  Hold'em No Limit ($0.01/$0.02) - 2014/09/03 6:22:52 ET
Table 'Halley' 6-max Seat #1 is the button
Seat 1: WeedBlowPill ($1.13 in chips) 
Seat 2: DistWork ($2 in chips) 
Seat 3: deoxy1909 ($0.94 in chips) 
Seat 4: Verstichel_P ($2.79 in chips) 
Seat 5: Oxi4OK1 ($2.16 in chips) 
Seat 6: bogimen90 ($2 in chips) 
DistWork: posts small blind $0.01
deoxy1909: posts big blind $0.02
*** HOLE CARDS ***
Dealt to deoxy1909 [Ac 3d]
Verstichel_P: folds 
Oxi4OK1: folds 
bogimen90: raises $0.04 to $0.06
WeedBlowPill: calls $0.06
DistWork: folds 
deoxy1909: folds 
*** FLOP *** [9s 4c 4h]
bogimen90: checks 
WeedBlowPill: bets $0.07
bogimen90: calls $0.07
*** TURN *** [9s 4c 4h] [Jh]
bogimen90: checks 
WeedBlowPill: checks 
*** RIVER *** [9s 4c 4h Jh] [5s]
bogimen90: bets $0.14
WeedBlowPill: calls $0.14
*** SHOW DOWN ***
bogimen90: shows [Ks Jc] (two pair, Jacks and Fours)
WeedBlowPill: mucks hand 
bogimen90 collected $0.55 from pot
*** SUMMARY ***
Total pot $0.57 | Rake $0.02 
Board [9s 4c 4h Jh 5s]
Seat 1: WeedBlowPill (button) mucked [Qh 9h]
Seat 2: DistWork (small blind) folded before Flop
Seat 3: deoxy1909 (big blind) folded before Flop
Seat 4: Verstichel_P folded before Flop (didn't bet)
Seat 5: Oxi4OK1 folded before Flop (didn't bet)
Seat 6: bogimen90 showed [Ks Jc] and won ($0.55) with two pair, Jacks and Fours



PokerStars Zoom Hand #120993738367:  Hold'em No Limit ($0.01/$0.02) - 2014/09/03 6:23:17 ET
Table 'Halley' 6-max Seat #1 is the button
Seat 1: wakali ($3.04 in chips) 
Seat 2: ilnar175 ($1.58 in chips) 
Seat 3: DSJekov ($2.32 in chips) 
Seat 4: deoxy1909 ($0.92 in chips) 
Seat 5: emo114 ($3.97 in chips) 
Seat 6: stgermain197 ($1.55 in chips) 
ilnar175: posts small blind $0.01
DSJekov: posts big blind $0.02
*** HOLE CARDS ***
Dealt to deoxy1909 [As Jd]
deoxy1909: raises $0.04 to $0.06
emo114: folds 
stgermain197: folds 
wakali: folds 
ilnar175: calls $0.05
DSJekov: folds 
*** FLOP *** [Jh Jc Qc]
ilnar175: bets $0.14
deoxy1909: raises $0.14 to $0.28
ilnar175: calls $0.14
*** TURN *** [Jh Jc Qc] [2c]
ilnar175: bets $0.68
deoxy1909: calls $0.58 and is all-in
Uncalled bet ($0.10) returned to ilnar175
*** RIVER *** [Jh Jc Qc 2c] [Qs]
*** SHOW DOWN ***
ilnar175: shows [9c 3c] (a flush, Queen high)
deoxy1909: shows [As Jd] (a full house, Jacks full of Queens)
deoxy1909 collected $1.79 from pot
*** SUMMARY ***
Total pot $1.86 | Rake $0.07 
Board [Jh Jc Qc 2c Qs]
Seat 1: wakali (button) folded before Flop (didn't bet)
Seat 2: ilnar175 (small blind) showed [9c 3c] and lost with a flush, Queen high
Seat 3: DSJekov (big blind) folded before Flop
Seat 4: deoxy1909 showed [As Jd] and won ($1.79) with a full house, Jacks full of Queens
Seat 5: emo114 folded before Flop (didn't bet)
Seat 6: stgermain197 folded before Flop (didn't bet)



PokerStars Zoom Hand #120994013059:  Hold'em No Limit ($0.01/$0.02) - 2014/09/03 6:33:27 ET
Table 'Halley' 6-max Seat #1 is the button
Seat 1: kEekeEKE ($2.06 in chips) 
Seat 2: DistWork ($2.01 in chips) 
Seat 3: Montreal98 ($0.89 in chips) 
Seat 4: deoxy1909 ($1.85 in chips) 
Seat 5: trelos24 ($2.38 in chips) 
Seat 6: LUKA 1ST ($0.17 in chips) 
DistWork: posts small blind $0.01
Montreal98: posts big blind $0.02
*** HOLE CARDS ***
Dealt to deoxy1909 [Jd Js]
deoxy1909: raises $0.04 to $0.06
trelos24: folds 
LUKA 1ST: folds 
kEekeEKE: folds 
DistWork: folds 
Montreal98: calls $0.04
*** FLOP *** [Ks 3c 8d]
Montreal98: checks 
deoxy1909: bets $0.08
Montreal98: raises $0.14 to $0.22
deoxy1909: calls $0.14
*** TURN *** [Ks 3c 8d] [3h]
Montreal98: bets $0.26
deoxy1909: folds 
Uncalled bet ($0.26) returned to Montreal98
Montreal98 collected $0.55 from pot
Montreal98: doesn't show hand 
*** SUMMARY ***
Total pot $0.57 | Rake $0.02 
Board [Ks 3c 8d 3h]
Seat 1: kEekeEKE (button) folded before Flop (didn't bet)
Seat 2: DistWork (small blind) folded before Flop
Seat 3: Montreal98 (big blind) collected ($0.55)
Seat 4: deoxy1909 folded on the Turn
Seat 5: trelos24 folded before Flop (didn't bet)
Seat 6: LUKA 1ST folded before Flop (didn't bet)



PokerStars Zoom Hand #120994041073:  Hold'em No Limit ($0.01/$0.02) - 2014/09/03 6:34:29 ET
Table 'Halley' 6-max Seat #1 is the button
Seat 1: deoxy1909 ($1.55 in chips) 
Seat 2: GaBBanZa ($0.50 in chips) 
Seat 3: Reklawegde ($2 in chips) 
Seat 4: Disharmonist ($2.03 in chips) 
Seat 5: PADROH ($1.31 in chips) 
Seat 6: BloodSavage ($2.03 in chips) 
GaBBanZa: posts small blind $0.01
Reklawegde: posts big blind $0.02
*** HOLE CARDS ***
Dealt to deoxy1909 [9s 6h]
Disharmonist: folds 
PADROH: raises $0.04 to $0.06
BloodSavage: folds 
deoxy1909: folds 
GaBBanZa: folds 
Reklawegde: raises $0.13 to $0.19
PADROH: calls $0.13
*** FLOP *** [5h 9d Jc]
Reklawegde: bets $0.19
PADROH: calls $0.19
*** TURN *** [5h 9d Jc] [Jh]
Reklawegde: bets $0.37
PADROH: raises $0.56 to $0.93 and is all-in
Reklawegde: calls $0.56
*** RIVER *** [5h 9d Jc Jh] [2c]
*** SHOW DOWN ***
Reklawegde: shows [Qd Qh] (two pair, Queens and Jacks)
PADROH: mucks hand 
Reklawegde collected $2.54 from pot
*** SUMMARY ***
Total pot $2.63 | Rake $0.09 
Board [5h 9d Jc Jh 2c]
Seat 1: deoxy1909 (button) folded before Flop (didn't bet)
Seat 2: GaBBanZa (small blind) folded before Flop
Seat 3: Reklawegde (big blind) showed [Qd Qh] and won ($2.54) with two pair, Queens and Jacks
Seat 4: Disharmonist folded before Flop (didn't bet)
Seat 5: PADROH mucked [8d 8s]
Seat 6: BloodSavage folded before Flop (didn't bet)



PokerStars Zoom Hand #120994082597:  Hold'em No Limit ($0.01/$0.02) - 2014/09/03 6:36:01 ET
Table 'Halley' 6-max Seat #1 is the button
Seat 1: deoxy1909 ($1.69 in chips) 
Seat 2: mrck14 ($2.07 in chips) 
Seat 3: Conseclusie ($2.13 in chips) 
Seat 4: halyav0s ($2 in chips) 
Seat 5: VikiUzhgorod ($2.04 in chips) 
Seat 6: ADevalois ($3.78 in chips) 
mrck14: posts small blind $0.01
Conseclusie: posts big blind $0.02
*** HOLE CARDS ***
Dealt to deoxy1909 [2h Jc]
halyav0s: raises $0.06 to $0.08
VikiUzhgorod: folds 
ADevalois: folds 
deoxy1909: folds 
mrck14: folds 
Conseclusie: raises $0.16 to $0.24
halyav0s: raises $0.30 to $0.54
Conseclusie: calls $0.30
*** FLOP *** [8c Jd 9h]
Conseclusie: checks 
halyav0s: checks 
*** TURN *** [8c Jd 9h] [5s]
Conseclusie: checks 
halyav0s: bets $1.46 and is all-in
Conseclusie: folds 
Uncalled bet ($1.46) returned to halyav0s
halyav0s collected $1.05 from pot
halyav0s: doesn't show hand 
*** SUMMARY ***
Total pot $1.09 | Rake $0.04 
Board [8c Jd 9h 5s]
Seat 1: deoxy1909 (button) folded before Flop (didn't bet)
Seat 2: mrck14 (small blind) folded before Flop
Seat 3: Conseclusie (big blind) folded on the Turn
Seat 4: halyav0s collected ($1.05)
Seat 5: VikiUzhgorod folded before Flop (didn't bet)
Seat 6: ADevalois folded before Flop (didn't bet)



PokerStars Zoom Hand #120994152639:  Hold'em No Limit ($0.01/$0.02) - 2014/09/03 6:38:37 ET
Table 'Halley' 6-max Seat #1 is the button
Seat 1: boyelsie ($2.52 in chips) 
Seat 2: VaNkaTa!112 ($2.15 in chips) 
Seat 3: deoxy1909 ($1.77 in chips) 
Seat 4: `Wid0ka$` ($4.01 in chips) 
Seat 5: Bugatti789 ($2.01 in chips) 
Seat 6: Droopy_3Bet ($3.97 in chips) 
VaNkaTa!112: posts small blind $0.01
deoxy1909: posts big blind $0.02
*** HOLE CARDS ***
Dealt to deoxy1909 [8h 6c]
`Wid0ka$`: folds 
Bugatti789: folds 
Droopy_3Bet: raises $0.04 to $0.06
boyelsie: calls $0.06
VaNkaTa!112: calls $0.05
deoxy1909: folds 
*** FLOP *** [Jc Qh Th]
VaNkaTa!112: checks 
Droopy_3Bet: bets $0.12
boyelsie: calls $0.12
VaNkaTa!112: folds 
*** TURN *** [Jc Qh Th] [3d]
Droopy_3Bet: bets $0.24
boyelsie: calls $0.24
*** RIVER *** [Jc Qh Th 3d] [8d]
Droopy_3Bet: bets $0.89
boyelsie: folds 
Uncalled bet ($0.89) returned to Droopy_3Bet
Droopy_3Bet collected $0.89 from pot
Droopy_3Bet: doesn't show hand 
*** SUMMARY ***
Total pot $0.92 | Rake $0.03 
Board [Jc Qh Th 3d 8d]
Seat 1: boyelsie (button) folded on the River
Seat 2: VaNkaTa!112 (small blind) folded on the Flop
Seat 3: deoxy1909 (big blind) folded before Flop
Seat 4: `Wid0ka$` folded before Flop (didn't bet)
Seat 5: Bugatti789 folded before Flop (didn't bet)
Seat 6: Droopy_3Bet collected ($0.89)



PokerStars Zoom Hand #120994163939:  Hold'em No Limit ($0.01/$0.02) - 2014/09/03 6:39:02 ET
Table 'Halley' 6-max Seat #1 is the button
Seat 1: deoxy1909 ($1.74 in chips) 
Seat 2: labros_108 ($2.11 in chips) 
Seat 3: jesoz76 ($1.29 in chips) 
Seat 4: ustas29 ($1.96 in chips) 
Seat 5: Reklawegde ($2.29 in chips) 
Seat 6: Anolulu ($2 in chips) 
labros_108: posts small blind $0.01
jesoz76: posts big blind $0.02
*** HOLE CARDS ***
Dealt to deoxy1909 [Jc 7h]
ustas29: folds 
Reklawegde: raises $0.04 to $0.06
Anolulu: calls $0.06
deoxy1909: folds 
labros_108: folds 
jesoz76: folds 
*** FLOP *** [3d Th 2h]
Reklawegde: bets $0.09
Anolulu: calls $0.09
*** TURN *** [3d Th 2h] [5c]
Reklawegde: bets $0.21
Anolulu: calls $0.21
*** RIVER *** [3d Th 2h 5c] [3c]
Reklawegde: bets $0.36
Anolulu: calls $0.36
*** SHOW DOWN ***
Reklawegde: shows [Ts Js] (two pair, Tens and Threes)
Anolulu: mucks hand 
Reklawegde collected $1.42 from pot
*** SUMMARY ***
Total pot $1.47 | Rake $0.05 
Board [3d Th 2h 5c 3c]
Seat 1: deoxy1909 (button) folded before Flop (didn't bet)
Seat 2: labros_108 (small blind) folded before Flop
Seat 3: jesoz76 (big blind) folded before Flop
Seat 4: ustas29 folded before Flop (didn't bet)
Seat 5: Reklawegde showed [Ts Js] and won ($1.42) with two pair, Tens and Threes
Seat 6: Anolulu mucked [4d 4c]



PokerStars Zoom Hand #120994295484:  Hold'em No Limit ($0.01/$0.02) - 2014/09/03 6:43:48 ET
Table 'Halley' 6-max Seat #1 is the button
Seat 1: lelemancio82 ($4.62 in chips) 
Seat 2: ustas29 ($3.11 in chips) 
Seat 3: WaiT4U ($2.11 in chips) 
Seat 4: ildar3200 ($2.27 in chips) 
Seat 5: zulug666 ($2.03 in chips) 
Seat 6: deoxy1909 ($1.24 in chips) 
ustas29: posts small blind $0.01
WaiT4U: posts big blind $0.02
*** HOLE CARDS ***
Dealt to deoxy1909 [Kd Kh]
ildar3200: folds 
zulug666: folds 
deoxy1909: raises $0.04 to $0.06
lelemancio82: folds 
ustas29: folds 
WaiT4U: calls $0.04
*** FLOP *** [6d Tc 2h]
WaiT4U: checks 
deoxy1909: bets $0.08
WaiT4U: raises $0.14 to $0.22
deoxy1909: raises $0.24 to $0.46
WaiT4U: folds 
Uncalled bet ($0.24) returned to deoxy1909
deoxy1909 collected $0.55 from pot
deoxy1909: doesn't show hand 
*** SUMMARY ***
Total pot $0.57 | Rake $0.02 
Board [6d Tc 2h]
Seat 1: lelemancio82 (button) folded before Flop (didn't bet)
Seat 2: ustas29 (small blind) folded before Flop
Seat 3: WaiT4U (big blind) folded on the Flop
Seat 4: ildar3200 folded before Flop (didn't bet)
Seat 5: zulug666 folded before Flop (didn't bet)
Seat 6: deoxy1909 collected ($0.55)



PokerStars Zoom Hand #120994428158:  Hold'em No Limit ($0.01/$0.02) - 2014/09/03 6:48:37 ET
Table 'Halley' 6-max Seat #1 is the button
Seat 1: parooney341 ($4.14 in chips) 
Seat 2: deoxy1909 ($1.59 in chips) 
Seat 3: gexownik ($2.39 in chips) 
Seat 4: spacer510 ($3.23 in chips) 
Seat 5: VaNkaTa!112 ($5.48 in chips) 
Seat 6: Stormzilla ($2 in chips) 
deoxy1909: posts small blind $0.01
gexownik: posts big blind $0.02
*** HOLE CARDS ***
Dealt to deoxy1909 [3d Kh]
spacer510: raises $0.04 to $0.06
VaNkaTa!112: folds 
Stormzilla: folds 
parooney341: folds 
deoxy1909: folds 
gexownik: calls $0.04
*** FLOP *** [3h 2h 5h]
gexownik: bets $0.06
spacer510: raises $0.06 to $0.12
gexownik: calls $0.06
*** TURN *** [3h 2h 5h] [Qs]
gexownik: checks 
spacer510: bets $0.36
gexownik: calls $0.36
*** RIVER *** [3h 2h 5h Qs] [9d]
gexownik: checks 
spacer510: bets $0.34
gexownik: calls $0.34
*** SHOW DOWN ***
spacer510: shows [6h Ah] (a flush, Ace high)
gexownik: mucks hand 
spacer510 collected $1.71 from pot
*** SUMMARY ***
Total pot $1.77 | Rake $0.06 
Board [3h 2h 5h Qs 9d]
Seat 1: parooney341 (button) folded before Flop (didn't bet)
Seat 2: deoxy1909 (small blind) folded before Flop
Seat 3: gexownik (big blind) mucked [2d 2s]
Seat 4: spacer510 showed [6h Ah] and won ($1.71) with a flush, Ace high
Seat 5: VaNkaTa!112 folded before Flop (didn't bet)
Seat 6: Stormzilla folded before Flop (didn't bet)



PokerStars Zoom Hand #120994465134:  Hold'em No Limit ($0.01/$0.02) - 2014/09/03 6:49:58 ET
Table 'Halley' 6-max Seat #1 is the button
Seat 1: skendroshen ($2.27 in chips) 
Seat 2: deoxy1909 ($1.70 in chips) 
Seat 3: Gevron ($2.46 in chips) 
Seat 4: Speebel ($6.88 in chips) 
Seat 5: smahatma ($2.03 in chips) 
Seat 6: artur21415 ($1.74 in chips) 
deoxy1909: posts small blind $0.01
Gevron: posts big blind $0.02
*** HOLE CARDS ***
Dealt to deoxy1909 [Ad Jh]
Speebel: raises $0.04 to $0.06
smahatma: folds 
artur21415: folds 
skendroshen: folds 
deoxy1909: calls $0.05
Gevron: folds 
*** FLOP *** [Kh As 6h]
deoxy1909: bets $0.08
Speebel: raises $6.74 to $6.82 and is all-in
deoxy1909: calls $1.56 and is all-in
Uncalled bet ($5.18) returned to Speebel
*** TURN *** [Kh As 6h] [5c]
*** RIVER *** [Kh As 6h 5c] [Qc]
*** SHOW DOWN ***
deoxy1909: shows [Ad Jh] (a pair of Aces)
Speebel: shows [Ac Kd] (two pair, Aces and Kings)
Speebel collected $3.30 from pot
*** SUMMARY ***
Total pot $3.42 | Rake $0.12 
Board [Kh As 6h 5c Qc]
Seat 1: skendroshen (button) folded before Flop (didn't bet)
Seat 2: deoxy1909 (small blind) showed [Ad Jh] and lost with a pair of Aces
Seat 3: Gevron (big blind) folded before Flop
Seat 4: Speebel showed [Ac Kd] and won ($3.30) with two pair, Aces and Kings
Seat 5: smahatma folded before Flop (didn't bet)
Seat 6: artur21415 folded before Flop (didn't bet)



PokerStars Zoom Hand #120994521165:  Hold'em No Limit ($0.01/$0.02) - 2014/09/03 6:51:59 ET
Table 'Halley' 6-max Seat #1 is the button
Seat 1: Baron Eugen ($1.66 in chips) 
Seat 2: deoxy1909 ($0.94 in chips) 
Seat 3: akinoshima ($2.03 in chips) 
Seat 4: scrpn666 ($3.04 in chips) 
Seat 5: Maker Given ($2.50 in chips) 
Seat 6: OMGClayAkien ($2.99 in chips) 
deoxy1909: posts small blind $0.01
akinoshima: posts big blind $0.02
*** HOLE CARDS ***
Dealt to deoxy1909 [6h Jh]
scrpn666: folds 
Maker Given: raises $0.04 to $0.06
OMGClayAkien: folds 
Baron Eugen: calls $0.06
deoxy1909: folds 
akinoshima: folds 
*** FLOP *** [3d 2d Qc]
Maker Given: checks 
Baron Eugen: checks 
*** TURN *** [3d 2d Qc] [2c]
Maker Given: bets $0.10
Baron Eugen: calls $0.10
*** RIVER *** [3d 2d Qc 2c] [3s]
Maker Given: checks 
Baron Eugen: bets $0.12
Maker Given: calls $0.12
*** SHOW DOWN ***
Baron Eugen: shows [Qs Qd] (a full house, Queens full of Threes)
Maker Given: mucks hand 
Baron Eugen collected $0.57 from pot
*** SUMMARY ***
Total pot $0.59 | Rake $0.02 
Board [3d 2d Qc 2c 3s]
Seat 1: Baron Eugen (button) showed [Qs Qd] and won ($0.57) with a full house, Queens full of Threes
Seat 2: deoxy1909 (small blind) folded before Flop
Seat 3: akinoshima (big blind) folded before Flop
Seat 4: scrpn666 folded before Flop (didn't bet)
Seat 5: Maker Given mucked [9c 9s]
Seat 6: OMGClayAkien folded before Flop (didn't bet)



PokerStars Zoom Hand #120994546967:  Hold'em No Limit ($0.01/$0.02) - 2014/09/03 6:52:55 ET
Table 'Halley' 6-max Seat #1 is the button
Seat 1: deoxy1909 ($0.89 in chips) 
Seat 2: halyav0s ($3.30 in chips) 
Seat 3: charlesley ($5.69 in chips) 
Seat 4: 11ivt ($2.31 in chips) 
Seat 5: placebo1970 ($0.61 in chips) 
Seat 6: plica634 ($1.88 in chips) 
halyav0s: posts small blind $0.01
charlesley: posts big blind $0.02
*** HOLE CARDS ***
Dealt to deoxy1909 [5d Th]
11ivt: folds 
placebo1970: folds 
plica634: raises $0.04 to $0.06
deoxy1909: folds 
halyav0s: raises $0.12 to $0.18
charlesley: folds 
plica634: calls $0.12
*** FLOP *** [9c Js 4d]
halyav0s: checks 
plica634: bets $0.18
halyav0s: calls $0.18
*** TURN *** [9c Js 4d] [Jc]
halyav0s: checks 
plica634: checks 
*** RIVER *** [9c Js 4d Jc] [3h]
halyav0s: checks 
plica634: bets $0.35
halyav0s: calls $0.35
*** SHOW DOWN ***
plica634: shows [6h 6d] (two pair, Jacks and Sixes)
halyav0s: shows [8d 9d] (two pair, Jacks and Nines)
halyav0s collected $1.39 from pot
*** SUMMARY ***
Total pot $1.44 | Rake $0.05 
Board [9c Js 4d Jc 3h]
Seat 1: deoxy1909 (button) folded before Flop (didn't bet)
Seat 2: halyav0s (small blind) showed [8d 9d] and won ($1.39) with two pair, Jacks and Nines
Seat 3: charlesley (big blind) folded before Flop
Seat 4: 11ivt folded before Flop (didn't bet)
Seat 5: placebo1970 folded before Flop (didn't bet)
Seat 6: plica634 showed [6h 6d] and lost with two pair, Jacks and Sixes



PokerStars Zoom Hand #120994562700:  Hold'em No Limit ($0.01/$0.02) - 2014/09/03 6:53:29 ET
Table 'Halley' 6-max Seat #1 is the button
Seat 1: Helebros ($2.08 in chips) 
Seat 2: deoxy1909 ($0.89 in chips) 
Seat 3: tamirija_ ($1.07 in chips) 
Seat 4: homeronriver ($2.59 in chips) 
Seat 5: Dzeris21 ($1.76 in chips) 
Seat 6: halyav0s ($3.13 in chips) 
deoxy1909: posts small blind $0.01
tamirija_: posts big blind $0.02
*** HOLE CARDS ***
Dealt to deoxy1909 [2d 2h]
homeronriver: folds 
Dzeris21: raises $0.06 to $0.08
halyav0s: folds 
Helebros: folds 
deoxy1909: calls $0.07
tamirija_: folds 
*** FLOP *** [2c 7h 7c]
deoxy1909: bets $0.12
Dzeris21: raises $1.56 to $1.68 and is all-in
deoxy1909: calls $0.69 and is all-in
Uncalled bet ($0.87) returned to Dzeris21
*** TURN *** [2c 7h 7c] [Kd]
*** RIVER *** [2c 7h 7c Kd] [Ac]
*** SHOW DOWN ***
deoxy1909: shows [2d 2h] (a full house, Deuces full of Sevens)
Dzeris21: shows [Jc Ah] (two pair, Aces and Sevens)
deoxy1909 collected $1.74 from pot
*** SUMMARY ***
Total pot $1.80 | Rake $0.06 
Board [2c 7h 7c Kd Ac]
Seat 1: Helebros (button) folded before Flop (didn't bet)
Seat 2: deoxy1909 (small blind) showed [2d 2h] and won ($1.74) with a full house, Deuces full of Sevens
Seat 3: tamirija_ (big blind) folded before Flop
Seat 4: homeronriver folded before Flop (didn't bet)
Seat 5: Dzeris21 showed [Jc Ah] and lost with two pair, Aces and Sevens
Seat 6: halyav0s folded before Flop (didn't bet)



PokerStars Zoom Hand #120994578450:  Hold'em No Limit ($0.01/$0.02) - 2014/09/03 6:54:03 ET
Table 'Halley' 6-max Seat #1 is the button
Seat 1: deoxy1909 ($1.74 in chips) 
Seat 2: zuzukala ($2.30 in chips) 
Seat 3: ustas29 ($2.40 in chips) 
Seat 4: BigTanya ($1.53 in chips) 
Seat 5: Myaccount777 ($2.09 in chips) 
Seat 6: doemitzer75 ($1.37 in chips) 
zuzukala: posts small blind $0.01
ustas29: posts big blind $0.02
*** HOLE CARDS ***
Dealt to deoxy1909 [Kc Jh]
BigTanya: raises $0.03 to $0.05
Myaccount777: folds 
doemitzer75: calls $0.05
deoxy1909: calls $0.05
zuzukala: folds 
ustas29: folds 
*** FLOP *** [4h 6s 2c]
BigTanya: bets $0.24
doemitzer75: calls $0.24
deoxy1909: folds 
*** TURN *** [4h 6s 2c] [4c]
BigTanya: bets $1.24 and is all-in
doemitzer75: calls $1.08 and is all-in
Uncalled bet ($0.16) returned to BigTanya
*** RIVER *** [4h 6s 2c 4c] [Th]
*** SHOW DOWN ***
BigTanya: shows [Ah As] (two pair, Aces and Fours)
doemitzer75: shows [4s 3s] (three of a kind, Fours)
doemitzer75 collected $2.72 from pot
*** SUMMARY ***
Total pot $2.82 | Rake $0.10 
Board [4h 6s 2c 4c Th]
Seat 1: deoxy1909 (button) folded on the Flop
Seat 2: zuzukala (small blind) folded before Flop
Seat 3: ustas29 (big blind) folded before Flop
Seat 4: BigTanya showed [Ah As] and lost with two pair, Aces and Fours
Seat 5: Myaccount777 folded before Flop (didn't bet)
Seat 6: doemitzer75 showed [4s 3s] and won ($2.72) with three of a kind, Fours



PokerStars Zoom Hand #120994624302:  Hold'em No Limit ($0.01/$0.02) - 2014/09/03 6:55:48 ET
Table 'Halley' 6-max Seat #1 is the button
Seat 1: dampovip ($2.11 in chips) 
Seat 2: Kasper447 ($0.79 in chips) 
Seat 3: deoxy1909 ($1.76 in chips) 
Seat 4: kimbo12345 ($2.03 in chips) 
Seat 5: demkos/81 ($2.10 in chips) 
Seat 6: Gatsby066 ($3.92 in chips) 
Kasper447: posts small blind $0.01
deoxy1909: posts big blind $0.02
*** HOLE CARDS ***
Dealt to deoxy1909 [8h 8d]
kimbo12345: folds 
demkos/81: folds 
Gatsby066: raises $0.04 to $0.06
dampovip: folds 
Kasper447: folds 
deoxy1909: calls $0.04
*** FLOP *** [9h 3h 8s]
deoxy1909: bets $0.08
Gatsby066: calls $0.08
*** TURN *** [9h 3h 8s] [Ad]
deoxy1909: bets $0.20
Gatsby066: calls $0.20
*** RIVER *** [9h 3h 8s Ad] [Qc]
deoxy1909: bets $0.52
Gatsby066: raises $3.06 to $3.58 and is all-in
deoxy1909: calls $0.90 and is all-in
Uncalled bet ($2.16) returned to Gatsby066
*** SHOW DOWN ***
Gatsby066: shows [Th Jd] (a straight, Eight to Queen)
deoxy1909: shows [8h 8d] (three of a kind, Eights)
Gatsby066 collected $3.41 from pot
*** SUMMARY ***
Total pot $3.53 | Rake $0.12 
Board [9h 3h 8s Ad Qc]
Seat 1: dampovip (button) folded before Flop (didn't bet)
Seat 2: Kasper447 (small blind) folded before Flop
Seat 3: deoxy1909 (big blind) showed [8h 8d] and lost with three of a kind, Eights
Seat 4: kimbo12345 folded before Flop (didn't bet)
Seat 5: demkos/81 folded before Flop (didn't bet)
Seat 6: Gatsby066 showed [Th Jd] and won ($3.41) with a straight, Eight to Queen



PokerStars Zoom Hand #120994830079:  Hold'em No Limit ($0.01/$0.02) - 2014/09/03 7:04:03 ET
Table 'Halley' 6-max Seat #1 is the button
Seat 1: deoxy1909 ($0.82 in chips) 
Seat 2: esab818 ($1.96 in chips) 
Seat 3: PokerProffi1 ($2.26 in chips) 
Seat 4: silevr stars ($4.86 in chips) 
Seat 5: papaduck33 ($11.26 in chips) 
Seat 6: tamirija_ ($0.73 in chips) 
esab818: posts small blind $0.01
PokerProffi1: posts big blind $0.02
*** HOLE CARDS ***
Dealt to deoxy1909 [8c 5d]
silevr stars: raises $0.04 to $0.06
papaduck33: folds 
tamirija_: folds 
deoxy1909: folds 
esab818: folds 
PokerProffi1: calls $0.04
*** FLOP *** [3h 7h 3s]
PokerProffi1: bets $0.09
silevr stars: raises $0.13 to $0.22
PokerProffi1: calls $0.13
*** TURN *** [3h 7h 3s] [5s]
PokerProffi1: checks 
silevr stars: bets $0.40
PokerProffi1: folds 
Uncalled bet ($0.40) returned to silevr stars
silevr stars collected $0.55 from pot
silevr stars: doesn't show hand 
*** SUMMARY ***
Total pot $0.57 | Rake $0.02 
Board [3h 7h 3s 5s]
Seat 1: deoxy1909 (button) folded before Flop (didn't bet)
Seat 2: esab818 (small blind) folded before Flop
Seat 3: PokerProffi1 (big blind) folded on the Turn
Seat 4: silevr stars collected ($0.55)
Seat 5: papaduck33 folded before Flop (didn't bet)
Seat 6: tamirija_ folded before Flop (didn't bet)



PokerStars Zoom Hand #120994949149:  Hold'em No Limit ($0.01/$0.02) - 2014/09/03 7:08:14 ET
Table 'Halley' 6-max Seat #1 is the button
Seat 1: Krasno_Soln ($2.18 in chips) 
Seat 2: deoxy1909 ($1 in chips) 
Seat 3: KarasBylba ($1.71 in chips) 
Seat 4: dsviridovich ($3.51 in chips) 
Seat 5: KlimSH ($2.28 in chips) 
Seat 6: muhata_10 ($6.95 in chips) 
deoxy1909: posts small blind $0.01
KarasBylba: posts big blind $0.02
*** HOLE CARDS ***
Dealt to deoxy1909 [5c 2d]
dsviridovich: folds 
KlimSH: raises $0.03 to $0.05
muhata_10: raises $0.17 to $0.22
Krasno_Soln: calls $0.22
deoxy1909: folds 
KarasBylba: raises $1.49 to $1.71 and is all-in
KlimSH: folds 
muhata_10: calls $1.49
Krasno_Soln: folds 
*** FLOP *** [6c 8h 3s]
*** TURN *** [6c 8h 3s] [Kd]
*** RIVER *** [6c 8h 3s Kd] [6h]
*** SHOW DOWN ***
KarasBylba: shows [7d 9d] (a pair of Sixes)
muhata_10: shows [Ks Ad] (two pair, Kings and Sixes)
muhata_10 collected $3.57 from pot
*** SUMMARY ***
Total pot $3.70 | Rake $0.13 
Board [6c 8h 3s Kd 6h]
Seat 1: Krasno_Soln (button) folded before Flop
Seat 2: deoxy1909 (small blind) folded before Flop
Seat 3: KarasBylba (big blind) showed [7d 9d] and lost with a pair of Sixes
Seat 4: dsviridovich folded before Flop (didn't bet)
Seat 5: KlimSH folded before Flop
Seat 6: muhata_10 showed [Ks Ad] and won ($3.57) with two pair, Kings and Sixes



PokerStars Zoom Hand #120995008113:  Hold'em No Limit ($0.01/$0.02) - 2014/09/03 7:10:17 ET
Table 'Halley' 6-max Seat #1 is the button
Seat 1: homeronriver ($4.45 in chips) 
Seat 2: deoxy1909 ($0.87 in chips) 
Seat 3: byter240 ($2.20 in chips) 
Seat 4: WaiT4U ($2.08 in chips) 
Seat 5: necro0811 ($1.99 in chips) 
Seat 6: Brutal1ty18 ($2 in chips) 
deoxy1909: posts small blind $0.01
byter240: posts big blind $0.02
*** HOLE CARDS ***
Dealt to deoxy1909 [As Ad]
WaiT4U: raises $0.05 to $0.07
necro0811: folds 
Brutal1ty18: folds 
homeronriver: folds 
deoxy1909: raises $0.15 to $0.22
byter240: folds 
WaiT4U: raises $1.86 to $2.08 and is all-in
deoxy1909: calls $0.65 and is all-in
Uncalled bet ($1.21) returned to WaiT4U
*** FIRST FLOP *** [Jh Kd 8h]
*** FIRST TURN *** [Jh Kd 8h] [5s]
*** FIRST RIVER *** [Jh Kd 8h 5s] [4c]
*** SECOND FLOP *** [Td 5h 6h]
*** SECOND TURN *** [Td 5h 6h] [Js]
*** SECOND RIVER *** [Td 5h 6h Js] [9h]
*** FIRST SHOW DOWN ***
deoxy1909: shows [As Ad] (a pair of Aces)
WaiT4U: shows [Qh Qs] (a pair of Queens)
deoxy1909 collected $0.85 from pot
*** SECOND SHOW DOWN ***
deoxy1909: shows [As Ad] (a pair of Aces)
WaiT4U: shows [Qh Qs] (a pair of Queens)
deoxy1909 collected $0.85 from pot
*** SUMMARY ***
Total pot $1.76 | Rake $0.06 
Hand was run twice
FIRST Board [Jh Kd 8h 5s 4c]
SECOND Board [Td 5h 6h Js 9h]
Seat 1: homeronriver (button) folded before Flop (didn't bet)
Seat 2: deoxy1909 (small blind) showed [As Ad] and won ($0.85) with a pair of Aces, and won ($0.85) with a pair of Aces
Seat 3: byter240 (big blind) folded before Flop
Seat 4: WaiT4U showed [Qh Qs] and lost with a pair of Queens, and lost with a pair of Queens
Seat 5: necro0811 folded before Flop (didn't bet)
Seat 6: Brutal1ty18 folded before Flop (didn't bet)



PokerStars Zoom Hand #120995068927:  Hold'em No Limit ($0.01/$0.02) - 2014/09/03 7:12:24 ET
Table 'Halley' 6-max Seat #1 is the button
Seat 1: vitaliyws ($3.41 in chips) 
Seat 2: aleekseenko ($1.15 in chips) 
Seat 3: deoxy1909 ($1.88 in chips) 
Seat 4: sluks ($2.03 in chips) 
Seat 5: BoBoNe93 ($2 in chips) 
Seat 6: ilonushka313 ($4.85 in chips) 
aleekseenko: posts small blind $0.01
deoxy1909: posts big blind $0.02
*** HOLE CARDS ***
Dealt to deoxy1909 [Kh 9s]
sluks: raises $0.04 to $0.06
BoBoNe93: folds 
ilonushka313: calls $0.06
vitaliyws: folds 
aleekseenko: folds 
deoxy1909: folds 
*** FLOP *** [4c 2s Jd]
sluks: bets $0.10
ilonushka313: calls $0.10
*** TURN *** [4c 2s Jd] [Ad]
sluks: checks 
ilonushka313: bets $0.17
sluks: calls $0.17
*** RIVER *** [4c 2s Jd Ad] [Ac]
sluks: checks 
ilonushka313: checks 
*** SHOW DOWN ***
sluks: shows [7h 7c] (two pair, Aces and Sevens)
ilonushka313: shows [Qd Ah] (three of a kind, Aces)
ilonushka313 collected $0.67 from pot
*** SUMMARY ***
Total pot $0.69 | Rake $0.02 
Board [4c 2s Jd Ad Ac]
Seat 1: vitaliyws (button) folded before Flop (didn't bet)
Seat 2: aleekseenko (small blind) folded before Flop
Seat 3: deoxy1909 (big blind) folded before Flop
Seat 4: sluks showed [7h 7c] and lost with two pair, Aces and Sevens
Seat 5: BoBoNe93 folded before Flop (didn't bet)
Seat 6: ilonushka313 showed [Qd Ah] and won ($0.67) with three of a kind, Aces



PokerStars Zoom Hand #120995132836:  Hold'em No Limit ($0.01/$0.02) - 2014/09/03 7:14:38 ET
Table 'Halley' 6-max Seat #1 is the button
Seat 1: ubione2222 ($1.93 in chips) 
Seat 2: 4CRUISE ($1.78 in chips) 
Seat 3: osel14 ($2.22 in chips) 
Seat 4: monster0816 ($1.20 in chips) 
Seat 5: deoxy1909 ($2.06 in chips) 
Seat 6: FBM_Braga ($1.18 in chips) 
4CRUISE: posts small blind $0.01
osel14: posts big blind $0.02
*** HOLE CARDS ***
Dealt to deoxy1909 [8s 8d]
monster0816: raises $0.04 to $0.06
deoxy1909: calls $0.06
FBM_Braga: folds 
ubione2222: folds 
4CRUISE: folds 
osel14: folds 
*** FLOP *** [Jc 5s 4s]
monster0816: bets $0.14
deoxy1909: calls $0.14
*** TURN *** [Jc 5s 4s] [7c]
monster0816: bets $0.22
deoxy1909: calls $0.22
*** RIVER *** [Jc 5s 4s 7c] [Td]
monster0816: bets $0.42
deoxy1909: calls $0.42
*** SHOW DOWN ***
monster0816: shows [Ah As] (a pair of Aces)
deoxy1909: mucks hand 
monster0816 collected $1.65 from pot
*** SUMMARY ***
Total pot $1.71 | Rake $0.06 
Board [Jc 5s 4s 7c Td]
Seat 1: ubione2222 (button) folded before Flop (didn't bet)
Seat 2: 4CRUISE (small blind) folded before Flop
Seat 3: osel14 (big blind) folded before Flop
Seat 4: monster0816 showed [Ah As] and won ($1.65) with a pair of Aces
Seat 5: deoxy1909 mucked [8s 8d]
Seat 6: FBM_Braga folded before Flop (didn't bet)



PokerStars Zoom Hand #120995164125:  Hold'em No Limit ($0.01/$0.02) - 2014/09/03 7:15:43 ET
Table 'Halley' 6-max Seat #1 is the button
Seat 1: MissMirta ($2.03 in chips) 
Seat 2: Krab506 ($3.01 in chips) 
Seat 3: Portilinho ($2 in chips) 
Seat 4: deoxy1909 ($1.19 in chips) 
Seat 5: robinheydorn ($4.47 in chips) 
Seat 6: sergiy6304 ($2.14 in chips) 
Krab506: posts small blind $0.01
Portilinho: posts big blind $0.02
*** HOLE CARDS ***
Dealt to deoxy1909 [6h 6s]
deoxy1909: raises $0.04 to $0.06
robinheydorn: folds 
sergiy6304: folds 
MissMirta: folds 
Krab506: folds 
Portilinho: calls $0.04
*** FLOP *** [6c Jc Kh]
Portilinho: checks 
deoxy1909: bets $0.08
Portilinho: calls $0.08
*** TURN *** [6c Jc Kh] [Jd]
Portilinho: checks 
deoxy1909: bets $0.20
Portilinho: calls $0.20
*** RIVER *** [6c Jc Kh Jd] [Js]
Portilinho: bets $1.66 and is all-in
deoxy1909: folds 
Uncalled bet ($1.66) returned to Portilinho
Portilinho collected $0.67 from pot
Portilinho: doesn't show hand 
*** SUMMARY ***
Total pot $0.69 | Rake $0.02 
Board [6c Jc Kh Jd Js]
Seat 1: MissMirta (button) folded before Flop (didn't bet)
Seat 2: Krab506 (small blind) folded before Flop
Seat 3: Portilinho (big blind) collected ($0.67)
Seat 4: deoxy1909 folded on the River
Seat 5: robinheydorn folded before Flop (didn't bet)
Seat 6: sergiy6304 folded before Flop (didn't bet)



PokerStars Zoom Hand #120986947911:  Hold'em No Limit ($0.01/$0.02) - 2014/09/03 0:00:45 ET
Table 'Halley' 6-max Seat #1 is the button
Seat 1: BlueRace00 ($2 in chips) 
Seat 2: ilmselgelt ($5.18 in chips) 
Seat 3: Saladisimooo ($1.74 in chips) 
Seat 4: Demonuga-73 ($1.72 in chips) 
Seat 5: deoxy1909 ($1.42 in chips) 
Seat 6: kan110 ($1.88 in chips) 
ilmselgelt: posts small blind $0.01
Saladisimooo: posts big blind $0.02
*** HOLE CARDS ***
Dealt to deoxy1909 [Kc Jh]
Demonuga-73: raises $0.04 to $0.06
deoxy1909: calls $0.06
kan110: calls $0.06
BlueRace00: folds 
ilmselgelt: folds 
Saladisimooo: calls $0.04
*** FLOP *** [2c 7d Jd]
Saladisimooo: folds 
Demonuga-73: bets $0.12
deoxy1909: raises $0.16 to $0.28
kan110: calls $0.28
Demonuga-73: folds 
*** TURN *** [2c 7d Jd] [9s]
deoxy1909: bets $1.08 and is all-in
kan110: calls $1.08
*** RIVER *** [2c 7d Jd 9s] [Ad]
*** SHOW DOWN ***
deoxy1909: shows [Kc Jh] (a pair of Jacks)
kan110: shows [7h 7c] (three of a kind, Sevens)
kan110 collected $2.98 from pot
*** SUMMARY ***
Total pot $3.09 | Rake $0.11 
Board [2c 7d Jd 9s Ad]
Seat 1: BlueRace00 (button) folded before Flop (didn't bet)
Seat 2: ilmselgelt (small blind) folded before Flop
Seat 3: Saladisimooo (big blind) folded on the Flop
Seat 4: Demonuga-73 folded on the Flop
Seat 5: deoxy1909 showed [Kc Jh] and lost with a pair of Jacks
Seat 6: kan110 showed [7h 7c] and won ($2.98) with three of a kind, Sevens



PokerStars Zoom Hand #120986963738:  Hold'em No Limit ($0.01/$0.02) - 2014/09/03 0:01:49 ET
Table 'Halley' 6-max Seat #1 is the button
Seat 1: F63.00 ($2.84 in chips) 
Seat 2: deoxy1909 ($1 in chips) 
Seat 3: lululu181 ($0.54 in chips) 
Seat 4: Starvn_degen ($0.54 in chips) 
Seat 5: kan110 ($3.43 in chips) 
Seat 6: AKADEM2 ($0.93 in chips) 
deoxy1909: posts small blind $0.01
lululu181: posts big blind $0.02
*** HOLE CARDS ***
Dealt to deoxy1909 [7c 7d]
Starvn_degen: raises $0.52 to $0.54 and is all-in
kan110: folds 
AKADEM2: calls $0.54
F63.00: folds 
deoxy1909: folds 
lululu181: folds 
*** FLOP *** [As 6s 8d]
*** TURN *** [As 6s 8d] [2d]
*** RIVER *** [As 6s 8d 2d] [Ts]
*** SHOW DOWN ***
Starvn_degen: shows [3s 3d] (a pair of Threes)
AKADEM2: shows [Qh Ah] (a pair of Aces)
AKADEM2 collected $1.07 from pot
*** SUMMARY ***
Total pot $1.11 | Rake $0.04 
Board [As 6s 8d 2d Ts]
Seat 1: F63.00 (button) folded before Flop (didn't bet)
Seat 2: deoxy1909 (small blind) folded before Flop
Seat 3: lululu181 (big blind) folded before Flop
Seat 4: Starvn_degen showed [3s 3d] and lost with a pair of Threes
Seat 5: kan110 folded before Flop (didn't bet)
Seat 6: AKADEM2 showed [Qh Ah] and won ($1.07) with a pair of Aces



PokerStars Zoom Hand #120986976971:  Hold'em No Limit ($0.01/$0.02) - 2014/09/03 0:02:40 ET
Table 'Halley' 6-max Seat #1 is the button
Seat 1: shushpanzer ($2.88 in chips) 
Seat 2: nightboy84 ($2 in chips) 
Seat 3: deoxy1909 ($1.02 in chips) 
Seat 4: Gaucho1070 ($2.70 in chips) 
Seat 5: maykl sem ($2.38 in chips) 
Seat 6: william55701 ($0.33 in chips) 
nightboy84: posts small blind $0.01
deoxy1909: posts big blind $0.02
*** HOLE CARDS ***
Dealt to deoxy1909 [Qs Kd]
Gaucho1070: raises $0.02 to $0.04
maykl sem: folds 
william55701: raises $0.29 to $0.33 and is all-in
shushpanzer: folds 
nightboy84: folds 
deoxy1909: folds 
Gaucho1070: calls $0.29
*** FLOP *** [Qd 6s 4d]
*** TURN *** [Qd 6s 4d] [Qh]
*** RIVER *** [Qd 6s 4d Qh] [7c]
*** SHOW DOWN ***
Gaucho1070: shows [4c Td] (two pair, Queens and Fours)
william55701: shows [Th Ts] (two pair, Queens and Tens)
william55701 collected $0.67 from pot
*** SUMMARY ***
Total pot $0.69 | Rake $0.02 
Board [Qd 6s 4d Qh 7c]
Seat 1: shushpanzer (button) folded before Flop (didn't bet)
Seat 2: nightboy84 (small blind) folded before Flop
Seat 3: deoxy1909 (big blind) folded before Flop
Seat 4: Gaucho1070 showed [4c Td] and lost with two pair, Queens and Fours
Seat 5: maykl sem folded before Flop (didn't bet)
Seat 6: william55701 showed [Th Ts] and won ($0.67) with two pair, Queens and Tens



PokerStars Zoom Hand #120986988289:  Hold'em No Limit ($0.01/$0.02) - 2014/09/03 0:03:24 ET
Table 'Halley' 6-max Seat #1 is the button
Seat 1: Energetic71 ($3.87 in chips) 
Seat 2: Evgenij1977 ($0.64 in chips) 
Seat 3: deoxy1909 ($1 in chips) 
Seat 4: 171112 ($2.35 in chips) 
Seat 5: xxxWEAZExxx ($4.83 in chips) 
Seat 6: AlfonsGH90 ($0.59 in chips) 
Evgenij1977: posts small blind $0.01
deoxy1909: posts big blind $0.02
*** HOLE CARDS ***
Dealt to deoxy1909 [6c 2d]
171112: folds 
xxxWEAZExxx: calls $0.02
AlfonsGH90: raises $0.06 to $0.08
Energetic71: folds 
Evgenij1977: folds 
deoxy1909: folds 
xxxWEAZExxx: calls $0.06
*** FLOP *** [Jd Ad Ts]
xxxWEAZExxx: checks 
AlfonsGH90: bets $0.51 and is all-in
xxxWEAZExxx: calls $0.51
*** TURN *** [Jd Ad Ts] [8d]
*** RIVER *** [Jd Ad Ts 8d] [5h]
*** SHOW DOWN ***
xxxWEAZExxx: shows [As 7s] (a pair of Aces)
AlfonsGH90: shows [3s Ks] (high card Ace)
xxxWEAZExxx collected $1.17 from pot
*** SUMMARY ***
Total pot $1.21 | Rake $0.04 
Board [Jd Ad Ts 8d 5h]
Seat 1: Energetic71 (button) folded before Flop (didn't bet)
Seat 2: Evgenij1977 (small blind) folded before Flop
Seat 3: deoxy1909 (big blind) folded before Flop
Seat 4: 171112 folded before Flop (didn't bet)
Seat 5: xxxWEAZExxx showed [As 7s] and won ($1.17) with a pair of Aces
Seat 6: AlfonsGH90 showed [3s Ks] and lost with high card Ace



PokerStars Zoom Hand #120987022516:  Hold'em No Limit ($0.01/$0.02) - 2014/09/03 0:05:36 ET
Table 'Halley' 6-max Seat #1 is the button
Seat 1: deoxy1909 ($1.11 in chips) 
Seat 2: Murzik100 ($2 in chips) 
Seat 3: kan110 ($2.04 in chips) 
Seat 4: hellboy7711 ($3.10 in chips) 
Seat 5: Zevon1 ($1.53 in chips) 
Seat 6: snowy_owl77 ($2.01 in chips) 
Murzik100: posts small blind $0.01
kan110: posts big blind $0.02
*** HOLE CARDS ***
Dealt to deoxy1909 [Ad Td]
hellboy7711: raises $0.03 to $0.05
Zevon1: raises $0.03 to $0.08
snowy_owl77: folds 
deoxy1909: folds 
Murzik100: folds 
kan110: folds 
hellboy7711: calls $0.03
*** FLOP *** [Jc 2c Qh]
hellboy7711: bets $0.13
Zevon1: calls $0.13
*** TURN *** [Jc 2c Qh] [3d]
hellboy7711: checks 
Zevon1: bets $0.20
hellboy7711: calls $0.20
*** RIVER *** [Jc 2c Qh 3d] [Qs]
hellboy7711: checks 
Zevon1: bets $0.82
hellboy7711: folds 
Uncalled bet ($0.82) returned to Zevon1
Zevon1 collected $0.82 from pot
Zevon1: doesn't show hand 
*** SUMMARY ***
Total pot $0.85 | Rake $0.03 
Board [Jc 2c Qh 3d Qs]
Seat 1: deoxy1909 (button) folded before Flop (didn't bet)
Seat 2: Murzik100 (small blind) folded before Flop
Seat 3: kan110 (big blind) folded before Flop
Seat 4: hellboy7711 folded on the River
Seat 5: Zevon1 collected ($0.82)
Seat 6: snowy_owl77 folded before Flop (didn't bet)



PokerStars Zoom Hand #120987087225:  Hold'em No Limit ($0.01/$0.02) - 2014/09/03 0:09:46 ET
Table 'Halley' 6-max Seat #1 is the button
Seat 1: csuti60 ($1.08 in chips) 
Seat 2: deoxy1909 ($1.11 in chips) 
Seat 3: sakippo ($9.04 in chips) 
Seat 4: sunrise2489 ($2.21 in chips) 
Seat 5: styry ($1.24 in chips) 
Seat 6: ghostmoney20 ($1.81 in chips) 
deoxy1909: posts small blind $0.01
sakippo: posts big blind $0.02
*** HOLE CARDS ***
Dealt to deoxy1909 [3h Td]
sunrise2489: folds 
styry: raises $0.04 to $0.06
ghostmoney20: folds 
csuti60: calls $0.06
deoxy1909: folds 
sakippo: folds 
*** FLOP *** [9h 5s Js]
styry: bets $0.08
csuti60: calls $0.08
*** TURN *** [9h 5s Js] [Ac]
styry: checks 
csuti60: checks 
*** RIVER *** [9h 5s Js Ac] [Jd]
styry: checks 
csuti60: bets $0.15
styry: calls $0.15
*** SHOW DOWN ***
csuti60: shows [Jc 8c] (three of a kind, Jacks)
styry: mucks hand 
csuti60 collected $0.59 from pot
*** SUMMARY ***
Total pot $0.61 | Rake $0.02 
Board [9h 5s Js Ac Jd]
Seat 1: csuti60 (button) showed [Jc 8c] and won ($0.59) with three of a kind, Jacks
Seat 2: deoxy1909 (small blind) folded before Flop
Seat 3: sakippo (big blind) folded before Flop
Seat 4: sunrise2489 folded before Flop (didn't bet)
Seat 5: styry mucked [4c 9s]
Seat 6: ghostmoney20 folded before Flop (didn't bet)



PokerStars Zoom Hand #120987115774:  Hold'em No Limit ($0.01/$0.02) - 2014/09/03 0:11:37 ET
Table 'Halley' 6-max Seat #1 is the button
Seat 1: Luojunyu ($4.23 in chips) 
Seat 2: kan110 ($1.81 in chips) 
Seat 3: Mikiki888 ($1.18 in chips) 
Seat 4: CaJIoKa ($5.10 in chips) 
Seat 5: vitalikto ($2.23 in chips) 
Seat 6: deoxy1909 ($1.15 in chips) 
kan110: posts small blind $0.01
Mikiki888: posts big blind $0.02
*** HOLE CARDS ***
Dealt to deoxy1909 [Jd As]
CaJIoKa: folds 
vitalikto: folds 
deoxy1909: raises $0.04 to $0.06
Luojunyu: calls $0.06
kan110: calls $0.05
Mikiki888: calls $0.04
*** FLOP *** [Ad Jh Kh]
kan110: checks 
Mikiki888: checks 
deoxy1909: bets $0.16
Luojunyu: folds 
kan110: calls $0.16
Mikiki888: folds 
*** TURN *** [Ad Jh Kh] [6s]
kan110: checks 
deoxy1909: bets $0.40
kan110: folds 
Uncalled bet ($0.40) returned to deoxy1909
deoxy1909 collected $0.54 from pot
deoxy1909: doesn't show hand 
*** SUMMARY ***
Total pot $0.56 | Rake $0.02 
Board [Ad Jh Kh 6s]
Seat 1: Luojunyu (button) folded on the Flop
Seat 2: kan110 (small blind) folded on the Turn
Seat 3: Mikiki888 (big blind) folded on the Flop
Seat 4: CaJIoKa folded before Flop (didn't bet)
Seat 5: vitalikto folded before Flop (didn't bet)
Seat 6: deoxy1909 collected ($0.54)



PokerStars Zoom Hand #120987149832:  Hold'em No Limit ($0.01/$0.02) - 2014/09/03 0:13:49 ET
Table 'Halley' 6-max Seat #1 is the button
Seat 1: sunrise2489 ($2.09 in chips) 
Seat 2: carlosid2009 ($2 in chips) 
Seat 3: maykl sem ($2.09 in chips) 
Seat 4: Marcika7 ($3.55 in chips) 
Seat 5: deoxy1909 ($1.49 in chips) 
Seat 6: Gosakh ($2.45 in chips) 
carlosid2009: posts small blind $0.01
maykl sem: posts big blind $0.02
*** HOLE CARDS ***
Dealt to deoxy1909 [3h 3s]
Marcika7: folds 
deoxy1909: raises $0.04 to $0.06
Gosakh: calls $0.06
sunrise2489: calls $0.06
carlosid2009: folds 
maykl sem: folds 
*** FLOP *** [2c 4d 5c]
deoxy1909: checks 
Gosakh: checks 
sunrise2489: bets $0.10
deoxy1909: calls $0.10
Gosakh: calls $0.10
*** TURN *** [2c 4d 5c] [Jd]
deoxy1909: checks 
Gosakh: checks 
sunrise2489: checks 
*** RIVER *** [2c 4d 5c Jd] [8c]
deoxy1909: checks 
Gosakh: checks 
sunrise2489: checks 
*** SHOW DOWN ***
deoxy1909: shows [3h 3s] (a pair of Threes)
Gosakh: mucks hand 
sunrise2489: shows [7s 7h] (a pair of Sevens)
sunrise2489 collected $0.49 from pot
*** SUMMARY ***
Total pot $0.51 | Rake $0.02 
Board [2c 4d 5c Jd 8c]
Seat 1: sunrise2489 (button) showed [7s 7h] and won ($0.49) with a pair of Sevens
Seat 2: carlosid2009 (small blind) folded before Flop
Seat 3: maykl sem (big blind) folded before Flop
Seat 4: Marcika7 folded before Flop (didn't bet)
Seat 5: deoxy1909 showed [3h 3s] and lost with a pair of Threes
Seat 6: Gosakh mucked [Th Ac]



PokerStars Zoom Hand #120987173956:  Hold'em No Limit ($0.01/$0.02) - 2014/09/03 0:15:24 ET
Table 'Halley' 6-max Seat #1 is the button
Seat 1: pankrat033 ($1.21 in chips) 
Seat 2: nadtz ($2 in chips) 
Seat 3: deoxy1909 ($1.31 in chips) 
Seat 4: ghostmoney20 ($1.92 in chips) 
Seat 5: LCDwish ($0.95 in chips) 
Seat 6: Thant0s ($3.27 in chips) 
nadtz: posts small blind $0.01
deoxy1909: posts big blind $0.02
*** HOLE CARDS ***
Dealt to deoxy1909 [Ks Ah]
ghostmoney20: folds 
LCDwish: folds 
Thant0s: folds 
pankrat033: raises $0.05 to $0.07
nadtz: folds 
deoxy1909: raises $0.11 to $0.18
pankrat033: calls $0.11
*** FLOP *** [6d 4c Ac]
deoxy1909: bets $0.26
pankrat033: raises $0.77 to $1.03 and is all-in
deoxy1909: calls $0.77
*** TURN *** [6d 4c Ac] [6c]
*** RIVER *** [6d 4c Ac 6c] [2s]
*** SHOW DOWN ***
deoxy1909: shows [Ks Ah] (two pair, Aces and Sixes)
pankrat033: shows [8c Kc] (a flush, Ace high)
pankrat033 collected $2.35 from pot
*** SUMMARY ***
Total pot $2.43 | Rake $0.08 
Board [6d 4c Ac 6c 2s]
Seat 1: pankrat033 (button) showed [8c Kc] and won ($2.35) with a flush, Ace high
Seat 2: nadtz (small blind) folded before Flop
Seat 3: deoxy1909 (big blind) showed [Ks Ah] and lost with two pair, Aces and Sixes
Seat 4: ghostmoney20 folded before Flop (didn't bet)
Seat 5: LCDwish folded before Flop (didn't bet)
Seat 6: Thant0s folded before Flop (didn't bet)


